# 中國歷代人物傳記資料庫（CBDB）
# https://projects.iq.harvard.edu/chinesecbdb/
# 原始資料為《明代登科錄彙編》及《天一閣藏明代科舉錄選刊.登科錄》，包含明朝52科的進士登科錄，共收錄14,116名進士信息。 
#
# 姓名	姓	名	字

吳伯宗	吳	伯宗	伯宗
郭翀	郭	翀	子翔
吳公達	吳	公達	致中
楊自立	楊	自立	子吾
趙友能	趙	友能	宗典
仇敬	仇	敬	仲立
丁輔	丁	輔	允正
吳鏞	吳	鏞	金川
黃載	黃	載	文傳
王敬中	王	敬中	
陳信之	陳	信之	信之
劉寅	劉	寅	拱辰
杜濬	杜	濬	亮之
王諫	王	諫	惟允
熊誼	熊	誼	判賓
盧貺	盧	貺	仲賓
周子諒	周	子諒	灌夫
毛煜	毛	煜	施伯
王誼	王	誼	翰英
趙旅	趙	旅	正己
姚宗敬	姚	宗敬	宗敬
王玄範	王	玄範	彥文
葉孝友	葉	孝友	孝友
尹宗伊	尹	宗伊	
金濤	金	濤	仲恬
岑鵬	岑	鵬	搏霄
李升	李	升	仲高
賈敏	賈	敏	克勤
梁臨	梁	臨	
聶鉉	聶	鉉	伯器
屠養浩	屠	養浩	
鄭廷實	鄭	廷實	禮賢
趙鑄	趙	鑄	子顏
張正一	張	正一	子明
洪燁	洪	燁	仲和
包莘	包	莘	尹耕
危孝先	危	孝先	簡言
馮麒	馮	麒	孟良
劉光先	劉	光先	鳴善
郭隣	郭	隣	
魏雲	魏	雲	雲從
魏益	魏	益	
張壽齡	張	壽齡	
林器之	林	器之	
趙實中	趙	實中	
俞友仁	俞	友仁	
王誠	王	誠	允誠
康縉	康	縉	宗正
聞伯異	聞	伯異	
童尹	童	尹	廷正
林信孚	林	信孚	信孚
陳執中	陳	執中	執中
林文壽	林	文壽	仲仁
王夏	王	夏	輔炎
黃綬	黃	綬	伯固
齊季舒	齊	季舒	
劉傑	劉	傑	
陳玄	陳	玄	
鄭潛	鄭	潛	
陳章應	陳	章應	敏達
彭泰	彭	泰	文淵
嚴植	嚴	植	景周
李素	李	素	
李初	李	初	
陳彝	陳	彝	原善
胡汝雨	胡	汝雨	均濟
管貞	管	貞	原清 
吳權	吳	權	巽行
張鶴	張	鶴	
劉伯欽	劉	伯欽	子敬
葉砥	葉	砥	屢道
林嘉	林	嘉	
劉鑄	劉	鑄	季冶
陳拱	陳	拱	叔向
何文信	何	文信	孟誠
傅晧	傅	晧	
韓守正	韓	守正	
何德舉	何	德舉	
王砥	王	砥	
馮本	馮	本	
林德亨	林	德亨	
林大同	林	大同	
爾朱欽	爾	朱欽	敬伯
伍洪	伍	洪	伯弘
鄧原忠	鄧	原忠	
蔡士實	蔡	士實	文光
葉德潛	葉	德潛	孔昭
王錫	王	錫	
梁安	梁	安	
楊文	楊	文	貫道
王中	王	中	
胡澄	胡	澄	以道
時執亮	時	執亮	
柳汝舟	柳	汝舟	處蘭
張堂	張	堂	
胡黻	胡	黻	
孫卓	孫	卓	
智審	智	審	
喻文龍	喻	文龍	叔雲
黃德潤	黃	德潤	端玉
丁時敏	丁	時敏	時敏
董時亮	董	時亮	彥功
陳韶	陳	韶	
胡宗禧	胡	宗禧	
余集	余	集	孟浩
劉中	劉	中	
周潼	周	潼	
薛大昉	薛	大昉	
鍾霆	鍾	霆	伯震
劉長輔	劉	長輔	孟質
鄭貞仲	鄭	貞仲	
黃鉞	黃	鉞	宗武
何子海	何	子海	
袁泰	袁	泰	
張必秦	張	必秦	子通
秦亨	秦	亨	
晉罡	晉	罡	
鄭鈞	鄭	鈞	
趙斗南	趙	斗南	
趙松	趙	松	
柯潛	柯	潛	孟時
劉昇	劉	昇	幼顯
王㒜	王	㒜	廷貴
吳匯	吳	匯	會川
周輿	周	輿	廷參
戚瀾	戚	瀾	文湍
王祐	王	祐	宗吉
林璟	林	璟	繼文
宋旻	宋	旻	弘澤
牟俸	牟	俸	公爵
吳鎡	吳	鎡	時可
陳杰	陳	杰	公佐
張永	張	永	邵齡
朱鏞	朱	鏞	廷用
吳遵	吳	遵	時極
袁凱	袁	凱	舜舉
吳璘	吳	璘	廷潤
吳智	吳	智	宏哲
趙謐	趙	謐	子安
桂山	桂	山	本寧
胡深	胡	深	本淵
孫仁	孫	仁	世榮
劉春	劉	春	緝昭
孫珉	孫	珉	宗理
呂晟	呂	晟	景熙
林鶚	林	鶚	一鶚
江彤	江	彤	而莊
鄭宏	鄭	宏	克寬
沈性	沈	性	士彛
盛昹	盛	昹	允高
余子俊	余	子俊	士英
唐瑜	唐	瑜	廷美
陳敬	陳	敬	體清
唐泰	唐	泰	時雍
黃深	黃	深	仲淵
李秉彜	李	秉彜	好德
汪浩	汪	浩	弘初
周監	周	監	文郁
王獻	王	獻	惟臣
張璿	張	璿	宗舜
李惠	李	惠	廷吉
劉子肅	劉	子肅	敬之
和維	和	維	振綱
周必兆	周	必兆	必兆
吳福	吳	福	天錫
李觀	李	觀	用賓
成凱	成	凱	舜卿
劉宣	劉	宣	紹和
朱華 	朱	華 	文輝
李鈞	李	鈞	許國
俞欽	俞	欽	振恭
胡欽	胡	欽	欽承
王琳	王	琳	充獻
相傑	相	傑	世英
陳嘉猷	陳	嘉猷	世用
陳僎	陳	僎	汝翼
楊守陳	楊	守陳	維新
張璣	張	璣	宗璿
陶復	陶	復	仕亨
鄧順	鄧	順	行健
周達	周	達	翔鳳
歐陽復	歐陽	復	時亨
夏塤	夏	塤	宗成
高明	高	明	上達
江玭	江	玭	用良
羅洪	羅	洪	從範
章格	章	格	韶鳳
周澂	周	澂	伯淵
張海	張	海	朝宗
陳鴻漸	陳	鴻漸	廷儀
顧珣	顧	珣	文之
潘本愚	潘	本愚	克明
陸昹	陸	昹	孟昭
童軒	童	軒	志昂
童緣	童	緣	大璋
李毓	李	毓	廷秀
鄧明	鄧	明	允哲
陳蕙	陳	蕙	秀儀
曹衡	曹	衡	宗衡
李瓛	李	瓛	世望
彭烈	彭	烈	肇烈
周欽	周	欽	守敬
王祥	王	祥	元吉
王越	王	越	世昌
吳琛	吳	琛	輿璧
張業	張	業	振烈
劉敷	劉	敷	叔榮
徐安行	徐	安行	允端
嚴誠	嚴	誠	克誠
尤瓉	尤	瓉	貴之
伍善	伍	善	元吉
湯懋	湯	懋	攻勉
蔡昇	蔡	昇	孟暘
陳顥	陳	顥	□□
朱銳	朱	銳	廷鉞
莫灝	莫	灝	景淵
歐賢	歐	賢	宗德
高禋	高	禋	惟寅
劉儉	劉	儉	宗禹
胡鍊	胡	鍊	允智
鄭林	鄭	林	伯森
樊冕	樊	冕	景瞻
林孔滋	林	孔滋	孔滋
游明	游	明	大昇
丁信	丁	信	誠之
陳善	陳	善	崇謙
戚寧	戚	寧	永康
郭本	郭	本	道允
程宗	程	宗	源伊
吳誠	吳	誠	尚忠
劉彞	劉	彞	惇倫 
楊青	楊	青	士昂
劉昭 	劉	昭 	克明
陽顯嘉	陽	顯嘉	謙亨
嚴憲	嚴	憲	廷章
許倫	許	倫	宗彛
楊福	楊	福	孟禧
劉紀	劉	紀	理之
王佐 	王	佐 	彥弼
岳璿	岳	璿	文璣
張鵬	張	鵬	騰霄
龍需	龍	需	邦舉
盛顒	盛	顒	時望
劉觀	劉	觀	廷賓
趙瑛	趙	瑛	玉輝
閻鐸	閻	鐸	文振
邵思祥	邵	思祥	夢麟
楊璡	楊	璡	文玉
李燁	李	燁	宗文
歐陽熙	歐陽	熙	時熙
李牧	李	牧	克治
郭紀	郭	紀	彥理
吳立	吳	立	大本 
鄭紘	鄭	紘	士冕
李勝	李	勝	惟吉
葉鸞 	葉	鸞 	應和
吳琛	吳	琛	景良
邵能	邵	能	舜賓
靳敏	靳	敏	時遜
羅晟	羅	晟	公亮
郝淵之	郝	淵之	希顏
龔謙	龔	謙	廷益
繆樸 	繆	樸 	尚質
李直 	李	直 	行斐
章亮	章	亮	文煥
楊榮	楊	榮	以仁
張瑄 	張	瑄 	廷圭
婁濬	婁	濬	潛夫
張信	張	信	成之
李宏	李	宏	有容
金文 	金	文 	尚德
謝燫	謝	燫	世彰
鍾清 	鍾	清 	景清
白良輔	白	良輔	舜臣
李衍 	李	衍 	文盛
章規	章	規	守規
田斌	田	斌	尚賢
何漢宗	何	漢宗	邦本
楊學	楊	學	文斆
洪弼	洪	弼	士直
秦紘	秦	紘	世纓
辛訪	辛	訪	咨道
王惟善	王	惟善	惟善
潘鏞	潘	鏞	克鳴
章表	章	表	翔鳳
楊昹	楊	昹	永明
項倬	項	倬	所洪
黃暉	黃	暉	有融
張瑄 	張	瑄 	廷璽
姚旭	姚	旭	景暘
王儀	王	儀	叔章
汪清 	汪	清 	源潔
王智	王	智	迁鑑
彭信	彭	信	中孚
莊歙	莊	歙	尚源
鄭佑	鄭	佑	孔佐
丁玘 	丁	玘 	文珩
李人儀	李	人儀	士傑
鍾同	鍾	同	世亰
應欽	應	欽	志欽
莊昇	莊	昇	景暘
鄭冕	鄭	冕	宜端
曹景	曹	景	廷彰
董廷圭	董	廷圭	國器
馬文升	馬	文升	負圖
徐廷章 	徐	廷章 	公器
劉泰 	劉	泰 	世亨
江朝宗	江	朝宗	東之
項愫	項	愫	思誠
吳綽	吳	綽	主寬
周清	周	清	本澄
鄧秀	鄧	秀	鍾英
張馵	張	馵	行敏
左興	左	興	傑夫
沈珒	沈	珒	公貴
葉巒	葉	巒	峻甫
鄭時	鄭	時	宗良
黃重	黃	重	金重 
趙銘	趙	銘	自新
張寬	張	寬	周弘
周斌	周	斌	國用
孫賢	孫	賢	舜卿
徐溥	徐	溥	時用
徐鎋	徐	鎋	文軾
丘濬	丘	濬	仲深
易貴	易	貴	天爵
程景雲	程	景雲	漢章
胡榮	胡	榮	希仁
陳琳	陳	琳	文璧
康麟	康	麟	文瑞
王鉉	王	鉉	廷器
黃謹	黃	謹	廷儀
謝綬	謝	綬	維章
李清	李	清	希獻
王朝遠	王	朝遠	朝遠
高宗本	高	宗本	茂卿
嚴端	嚴	端	克正
孔公恂	孔	公恂	宗文
史瓘	史	瓘	德輝
張寧	張	寧	靖之
耿裕	耿	裕	好問
徐鑾	徐	鑾	用和
劉洪	劉	洪	文裕
孫輝	孫	輝	德昭
彭華	彭	華	彥實
劉釪	劉	釪	仗和
陳龍	陳	龍	元亮
杜宥	杜	宥	叔寬
張畹	張	畹	茂蘭
黃隆	黃	隆	自立
張黼	張	黼	良甫
張祚	張	祚	永錫
謝士元	謝	士元	仲仁
顧瑾	顧	瑾	季琮
章瑄	章	瑄	用輝
盧秩	盧	秩	崇績
曾會	曾	會	以文
浦鏞	浦	鏞	廷用
朱倫	朱	倫	迪彝
黎永明	黎	永明	光亨
閻本	閻	本	宗元
苗灝	苗	灝	勢遠
魏銘	魏	銘	日新
程鑑	程	鑑	孔昭
王穀	王	穀	萬石
歐廉	歐	廉	仕潔
蔣紱	蔣	紱	洪章
陳璧	陳	璧	仲奎
李芳	李	芳	本春
劉瑄	劉	瑄	廷璧
楊集	楊	集	浩然
王齊	王	齊	內肅
宋榮	宋	榮	弘仁
范鏞	范	鏞	彥聲
許誾	許	誾	和仲
牛綸	牛	綸	大經
林思承	林	思承	思承
孟勳	孟	勳	守謙
何琮	何	琮	文璧
費廣	費	廣	孟博
伍方	伍	方	公矩
卓天錫	卓	天錫	純嘏
黃會	黃	會	吉劭
焦顯	焦	顯	文明
杜謙	杜	謙	益之
屈銓	屈	銓	天衡
林時讓	林	時讓	純禮
吳禎	吳	禎	從善
何喬新	何	喬新	廷秀
莊敬	莊	敬	克誠
魯能	魯	能	千之
陳瑄	陳	瑄	廷獻
楊緯	楊	緯	宗武
蕭青	蕭	青	廷翠
曾唯	曾	唯	子一
陳雲鶚	陳	雲鶚	翔之
趙文博	趙	文博	守約
王衡	王	衡	文璿
邵銅	邵	銅	振聲
黃紀	黃	紀	憲邦
吳節	吳	節	汝節
陳雲	陳	雲	時望
侯瓚	侯	瓚	奉璋
魯崇志	魯	崇志	崇志
郁文博	郁	文博	文博
馬進	馬	進	惟學
李曰良	李	曰良	朝佐
謝省	謝	省	世脩
高舉	高	舉	汝賢
呂益	呂	益	伯謙
賈奭	賈	奭	希召
黃紳	黃	紳	朝儀
嚴洤	嚴	洤	宗源
塗淮	塗	淮	達夫
沈富	沈	富	好禮
趙昌	趙	昌	鳴盛
楊琚	楊	琚	朝用
董琳	董	琳	廷瑞
葉萱	葉	萱	廷茂
宋有文	宋	有文	顯章
桂琛	桂	琛	獻之
尹直	尹	直	正言
鄭珪	鄭	珪	叔瀾
劉溥	劉	溥	濬淵
鄭瑛	鄭	瑛	邦潤
李宗學	李	宗學	致用
吳顯	吳	顯	文謨
周瑛	周	瑛	廷潤
劉倫正	劉	倫正	理敘
陳貴	陳	貴	秉良
傅韶	傅	韶	德音
袁潤	袁	潤	習德
楊恕	楊	恕	尚忠
趙博	趙	博	克周
范文	范	文	德彰
郭仲珣	郭	仲珣	叔玉
江勛	江	勛	元勛
汪霖	汪	霖	潤夫
單昂	單	昂	廷舉
豐載	豐	載	持厚
龍晉	龍	晉	遵敘
顏正	顏	正	廷表
徐海	徐	海	德容
楊釜	楊	釜	受□
周琦	周	琦	宗玉
劉永通	劉	永通	弘濟
鄭文奎	鄭	文奎	永章
李木	李	木	時升
鍾珹	鍾	珹	德卿
劉璧	劉	璧	次瑋
唐彬	唐	彬	質夫
李敏	李	敏	公勉
錢源	錢	源	有本
崔忠	崔	忠	誠之
潘傑	潘	傑	士英
胡福	胡	福	百順
徐毅	徐	毅	士弘
王常	王	常	正倫
李褒	李	褒	濟美
徐宗	徐	宗	大本
熊俊	熊	俊	子英
錢俊	錢	俊	時乂
張浩	張	浩	養正
王臣	王	臣	公輔
陳政	陳	政	宣之
劉顯	劉	顯	光祖
李益	李	益	景賢
寧珍	寧	珍	伯珍
王春	王	春	載陽
胡德盛	胡	德盛	尚愚
曾清	曾	清	本澄
翟政	翟	政	以德
方逵	方	逵	景由
錢璡	錢	璡	廷珍
鄭華	鄭	華	思賢
夏璣	夏	璣	德乾
胡寬	胡	寬	有容
蔣昂	蔣	昂	用璋
鄭同	鄭	同	本初
王紀	王	紀	肇脩
勞鉞	勞	鉞	廷器
鄭岑	鄭	岑	子高
鄒永昌	鄒	永昌	慶夫
林雍	林	雍	萬容
孔鏞	孔	鏞	韶文
王鑑	王	鑑	彥昭
劉恕	劉	恕	寬仁
上泰	上	泰	志同
梁矩	梁	矩	叔方
馬聰	馬	聰	體哲
劉珂	劉	珂	尚珮
孫璚	孫	璚	廷玉
顏夔	顏	夔	士奇
王豫	王	豫	用誠
翁經	翁	經	載道
滕佐	滕	佐	良輔
沈聲	沈	聲	廷和
孟淮	孟	淮	宗海
郁綸	郁	綸	理之
黃讓	黃	讓	用遜
楊清	楊	清	汝正
蔣瑄	蔣	瑄	文璽
林孔仁	林	孔仁	孔仁
劉謨	劉	謨	應咨
黎庸	黎	庸	通理
羅淮	羅	淮	潤民
王績	王	績	功偉
于琇	于	琇	廷玉
李瓘	李	瓘	叔玉
章律	章	律	鳴鳳
楊瑄	楊	瑄	廷獻
王重	王	重	式鈞
金澤	金	澤	用文
王用	王	用	廷用
謝瑀	謝	瑀	叔和
許顒	許	顒	孟敬
王魯	王	魯	希曾
劉濟	劉	濟	彥霑
林宗	林	宗	惟正
李常	李	常	亨常
朱紳	朱	紳	大用
李溥	李	溥	大濟
馮韺	馮	韺	惟和
周正	周	正	直卿
桂茂之	桂	茂之	廷秀
鄧廷瓚	鄧	廷瓚	宗器
聊讓	聊	讓	公遜
李稷	李	稷	廷貴
吳㻞	吳	㻞	德潤
李巽	李	巽	用經
楊紹	楊	紹	紹宗
劉寅之	劉	寅之	主敬
阮勤	阮	勤	必成
何玘	何	玘	廷用
呂恕	呂	恕	希仁
左源	左	源	大本
蔣敵	蔣	敵	宗仁
楊壁	楊	壁	應奎
李景孟	李	景孟	宗浩
秦玘	秦	玘	伯玉
曹隆	曹	隆	邦盛
彭盛	彭	盛	永昌
馮定	馮	定	士定
何淵	何	淵	有本
吳讓	吳	讓	克讓
史珍	史	珍	廷玉
孫忱	孫	忱	誠之
水桓	水	桓	廷圭
張岐	張	岐	來鳳
董淵	董	淵	宗本
吳中	吳	中	□□
丁慈	丁	慈	元愷
康驥	康	驥	德良
王欽	王	欽	允恭
孫敬	孫	敬	孟寅
王珪	王	珪	廷玉
王瓘	王	瓘	廷用
李田	李	田	舜耕
聶元	聶	元	存善
林傑	林	傑	廷賓
趙敔	趙	敔	叔成
張奎	張	奎	漢文
于坦	于	坦	尚平
王稽	王	稽	允哲
毛傑	毛	傑	允奇
李麟	李	麟	文瑞
王昇	王	昇	起東
洪冕	洪	冕	廷章
曹泰	曹	泰	以安
田濟	田	濟	汝霖
劉傑	劉	傑	世英
徐觀	徐	觀	子明
畢亨	畢	亨	文亨
趙相	趙	相	文卿
戴珙	戴	珙	廷璧
李裕	李	裕	咨德
劉季清	劉	季清	士廉
徐紳	徐	紳	公儀
李嗣	李	嗣	克承
鄭瑞	鄭	瑞	孟祥
裴衷	裴	衷	秉彝
李璵	李	璵	廷瑞
夏忠	夏	忠	克誠
王盧	王	盧	廷器
郭舒	郭	舒	端莊
楊宣	楊	宣	子穡
陳孟晟	陳	孟晟	尚晦
楊琛	楊	琛	叔瓛
史蘭	史	蘭	廷芳
茂彪	茂	彪	宗彝
張綱	張	綱	大振
張僖	張	僖	世樂
龍霖	龍	霖	用謨
武齊	武	齊	廣□
劉瑄	劉	瑄	宗器
王璘	王	璘	廷秀
吳玘	吳	玘	仲玉
劉清	劉	清	源潔
劉孜	劉	孜	師侃
冉哲	冉	哲	尚彝
吳庚	吳	庚	仲明
劉岌	劉	岌	凌雲
羅明	羅	明	元亮
田景暘	田	景暘	時中
伍驥	伍	驥	體馴
魏瀚	魏	瀚	九淵
程泰	程	泰	用元
杜庠	杜	庠	公序
葉頤	葉	頤	養正
金紳	金	紳	縉卿
李岳	李	岳	世瞻
鄭安	鄭	安	康民
吳節	吳	節	行儉
黃甄	黃	甄	器之
李述	李	述	繼之
張贊	張	贊	邦翊
毛吉	毛	吉	宗吉
蕭惟昌	蕭	惟昌	有慶
段堅	段	堅	可久
宋澄	宋	澄	惟清
呂洪	呂	洪	大正
楊懋	楊	懋	克勤
樊英	樊	英	世傑
白侃	白	侃	廷直
汪振	汪	振	□□
謝廉	謝	廉	允清
徐宗	徐	宗	叔本
邢簡	邢	簡	居敬
趙章	趙	章	彥達
劉蔭	劉	蔭	弘基
婁瑾	婁	瑾	公玉
王寬	王	寬	居仁
俞璟	俞	璟	景明
何經	何	經	宗易
施奇	施	奇	廷偉
張述古	張	述古	信之
毛倫	毛	倫	天敘
孫珂	孫	珂	廷珍
楊宣	楊	宣	振方
高亮	高	亮	尚明
李昂	李	昂	文舉
劉充	劉	充	恭擴
李文	李	文	載道
周鼐	周	鼐	宗用
金純	金	純	文明
金禮	金	禮	敬之
孫洪	孫	洪	伯大
方暕	方	暕	文郁
王聰	王	聰	彥聞
夏時	夏	時	孟寅
程萬鍾	程	萬鍾	廷錫
閻鼐	閻	鼐	仲輔
陳儼	陳	儼	時莊
劉瑜	劉	瑜	彥琢
李志綱	李	志綱	振紀
熊惠	熊	惠	迪吉
韓殷	韓	殷	阜民
周晟	周	晟	德明
周一清	周	一清	廉夫
王度	王	度	洪量
王詔	王	詔	廷徵
王上齡	王	上齡	大壽
牛宣	牛	宣	德敷
俞紀	俞	紀	憲□
沈黻	沈	黻	孰辯
沈譓	沈	譓	用正
黎淳	黎	淳	太樸
徐瓊	徐	瓊	時庸
陳秉中	陳	秉中	宗堯
宋瑛	宋	瑛	克輝
徐綺	徐	綺	景文
張琦	張	琦	宋卿
羅崇嶽	羅	崇嶽	仰止
楊琮	楊	琮	廷璋
彭彥充	彭	彥充	仲英
周易同	周	易同	宗羲
李慶	李	慶	宗善
左贊	左	贊	時翊
劉瀚	劉	瀚	約之
袁芳	袁	芳	時烈
許起	許	起	立之
陳伯良	陳	伯良	易之
趙熙	趙	熙	惟緝
何淡	何	淡	中美
柳瑛	柳	瑛	廷玉
路璋	路	璋	斐章
石澄	石	澄	士廉
范純	范	純	誠夫
夏積	夏	積	孚英
劉伯川	劉	伯川	東之
劉任治	劉	任治	篤棐
郭澄	郭	澄	廉夫
王瑤	王	瑤	良玉
龐勝	龐	勝	復理
彭韶	彭	韶	鳳儀
楊禮	楊	禮	以敬
陳懋	陳	懋	尚敬
黃憲	黃	憲	景章
徐文湋	徐	文湋	若川
劉澄	劉	澄	巨囦
虞鐘	虞	鐘	廷宣
黃塤	黃	塤	叔和
孫信	孫	信	中孚
夏澄	夏	澄	宗廉
鄭鼐	鄭	鼐	公實
陳瑾	陳	瑾	季玉
陳迪	陳	迪	元吉
謝芳	謝	芳	景昌
門相	門	相	良弼
潘洪	潘	洪	克寬
李佐	李	佐	廷相
葉華	葉	華	廷輝
計昌	計	昌	汝賢
劉槃	劉	槃	克用
楊士倧	楊	士倧	原父
宋訥	宋	訥	近仁
朱貞	朱	貞	惟正
葉敏	葉	敏	汝行
曾文	曾	文	應彬
展毓	展	毓	鍾秀
于欽	于	欽	致恭
石後	石	後	先之
唐珣	唐	珣	廷貴
楊冕	楊	冕	致美
徐顯	徐	顯	東昭
陳載	陳	載	景厚
張璝	張	璝	德潤
王顯	王	顯	必融
胡深	胡	深	道源
劉隆	劉	隆	徽林
吳遠	吳	遠	敬行
張翥	張	翥	汝振
夏志明	夏	志明	惟公
馮安	馮	安	汝止
萬翼	萬	翼	□之
趙瑛	趙	瑛	彥華
羅訓	羅	訓	丕訓
蔣雲漢	蔣	雲漢	天章
袁潔	袁	潔	士瑩
劉本	劉	本	源之
楊繼宗	楊	繼宗	承芳
胡信	胡	信	宗實
游浩	游	浩	盛如
孟顓	孟	顓	克勤
陳綱	陳	綱	立之
周謨	周	謨	守謨
蔡誌	蔡	誌	克存
馮敬	馮	敬	子欽
彭果	彭	果	仕顯
陸鏞	陸	鏞	時鳴
鄭克和	鄭	克和	克和
嚴祖興	嚴	祖興	廷傑
鄒和	鄒	和	允達
馮孜	馮	孜	師虞
何衷	何	衷	惟孝
吳森	吳	森	以時
楊壽	楊	壽	愷之
端宏	端	宏	仲仁
俞澤	俞	澤	汝霖
樂章	樂	章	宗堯
馮銀	馮	銀	純端
劉觀	劉	觀	文光
李璲	李	璲	崇信
孔宗顯	孔	宗顯	弘章
倪顒	倪	顒	廷瞻
楊完	楊	完	德金
姚昹	姚	昹	景昭
白昂	白	昂	廷儀
王道	王	道	允志
應瀚	應	瀚	克涵
談倫	談	倫	本彛
蔡哲	蔡	哲	克智
楊魁	楊	魁	用元
徐虔	徐	虔	宗敬
王豎	王	豎	希成
劉鐸	劉	鐸	以道
黃金	黃	金	廷貴
李澄	李	澄	希范
盧茂	盧	茂	元實
邵震	邵	震	瞻宸
金醞	金	醞	大用
王預	王	預	立誠
黃箎	黃	箎	仲和
梁昉	梁	昉	景熙
吳道宏	吳	道宏	文博
劉秩	劉	秩	厚本
喻本中	喻	本中	體道
吳錫	吳	錫	天祐
陳渤	陳	渤	臣源
劉潺	劉	潺	宗瀾
王克復	王	克復	師仁
范奎	范	奎	景星
文志貞	文	志貞	正夫
霍鑑	霍	鑑	文昭
劉必賢	劉	必賢	天佑
吳珵	吳	珵	汝璉
吉惠	吉	惠	澤民
莊澈	莊	澈	瑩中
劉俊	劉	俊	朝用
朱檃	朱	檃	伯承
張鑑	張	鑑	景昭
尹進	尹	進	時敏
姜清	姜	清	子澄
楊瓚	楊	瓚	宗器
劉溥	劉	溥	大濟
王存禮	王	存禮	景節
胡謐	胡	謐	廷慎
崔儀	崔	儀	文威
王冕	王	冕	廷儀
文宜	文	宜	時中
毛弘	毛	弘	士廣
杜鈜	杜	鈜	聞遠
王道	王	道	世用
黎遜	黎	遜	希讓
孫芳	孫	芳	庭桂
秦民悅	秦	民悅	崇化
林棨	林	棨	從信
徐貫	徐	貫	原一
胡璉	胡	璉	重器
張本濟	張	本濟	汝楫
喬鳳	喬	鳳	廷儀
鄭勤	鄭	勤	必成
梁明	梁	明	廷光
蔡麟	蔡	麟	文瑞
趙傑	趙	傑	冠英
許聰	許	聰	聽德
王佐	王	佐	廷輔
于懋	于	懋	文勉
周正	周	正	子建
邢表	邢	表	居正
劉璋	劉	璋	廷信
方朝宗	方	朝宗	朝宗
梁材	梁	材	大用
方嵩	方	嵩	景高
宋賓	宋	賓	彥卿
張祚	張	祚	宗胤
王淵	王	淵	志默
李綱	李	綱	廷張
湯琛	湯	琛	魯寶
馬馴	馬	馴	子良
韓祺	韓	祺	汝徵
顧正	顧	正	孟端
韓文	韓	文	貫道
黃觀	黃	觀	國賓
李祥	李	祥	廷瑞
朱寬	朱	寬	宏裕
王翰	王	翰	廷舉
霍貴	霍	貴	廷重
常寧	常	寧	文靜
車振	車	振	弘道
吳忱	吳	忱	永誠
凌文	凌	文	從周
徐源	徐	源	本清
盧信	盧	信	廷瑞
薛璘	薛	璘	美玉
顧以山	顧	以山	安道
魏元	魏	元	景善
張洽	張	洽	時繹
謝敬	謝	敬	克恭
潘珪	潘	珪	公瑞
張綱	張	綱	秉常
宋德	宋	德	大本
吳澮	吳	澮	原深
韋嵩	韋	嵩	宗嶽
吳寧	吳	寧	文靖
林迪	林	迪	允吉
左賢	左	賢	時彥
張翓	張	翓	鵬舉
鍾震	鍾	震	大聲
張祥	張	祥	維和
丁璐	丁	璐	元美
左明善	左	明善	思誠
程萬里	程	萬里	道遠
黃縉	黃	縉	世用
徐貫	徐	貫	從道
陳鉞	陳	鉞	廷威
邢正	邢	正	直夫
周同伯	周	同伯	敬同
紀逵	紀	逵	文逵
吳淵	吳	淵	本深
徐英	徐	英	時傑
李炯然	李	炯然	漢章
上志	上	志	宗道
裴慧	裴	慧	悟理
晏文顯	晏	文顯	崇道
何禮	何	禮	文敬
方中	方	中	大本
馬體乾	馬	體乾	自強
盧雍	盧	雍	廷佐
趙文萃	趙	文萃	儒夫
陳騏	陳	騏	夢祥
陶鎔	陶	鎔	汝器
趙通	趙	通	惟亨
張倫	張	倫	秉彛
曹奇	曹	奇	仕奇
賴正	賴	正	文正
韓恭	韓	恭	克讓
崔浩	崔	浩	文淵
簡嘉誥	簡	嘉誥	承命
夏環	夏	環	曰謙
吳真	吳	真	秉誠
羅脩	羅	脩	脩爵
熊懷	熊	懷	性實
李端	李	端	宗正
程霓	程	霓	民望
胡睿	胡	睿	好聞
羅廣	羅	廣	大用
陳亨	陳	亨	惟嘉
李森	李	森	時茂
王瓚	王	瓚	廷器
周琳	周	琳	廷貴
曾瑄	曾	瑄	廷獻
吳琮	吳	琮	廷璋
張戟	張	戟	器之
熊瑞	熊	瑞	廷珪
陳爵	陳	爵	良貴
崔珣	崔	珣	伯玉
吳繹思	吳	繹思	繹思
莫謙	莫	謙	益之
張賓	張	賓	利用
王秉彛	王	秉彛	性之
潘琴	潘	琴	舜弦
劉誠	劉	誠	敬之
易居仁	易	居仁	民表
程廣	程	廣	克勤
吳遜	吳	遜	守謙
沈珤	沈	珤	庭實
郭良	郭	良	克忠
董振	董	振	廷顯
陳珍	陳	珍	世重
周峻	周	峻	維高
李贊	李	贊	尚忠
高橙	高	橙	彥村
田瑄	田	瑄	德潤
嚴萱	嚴	萱	廷暉
周轍	周	轍	恒守
方佑	方	佑	廷輔
段寧	段	寧	伯安
楊孟芳	楊	孟芳	景春
高安	高	安	邦寧
顧能	顧	能	宜用
李翔	李	翔	鵬遠
徐茂	徐	茂	景芳
畢玉	畢	玉	廷璽
楊大榮	楊	大榮	崇仁
徐貴	徐	貴	良貴
顧鏡	顧	鏡	自昭
章顒	章	顒	士昂
龔鼎	龔	鼎	大器
林孟喬	林	孟喬	孟喬
錢達	錢	達	景通
李麟	李	麟	文祥
白鳳	白	鳳	世禎
劉昊	劉	昊	孟元
雷霖	雷	霖	弘濟
馬桓	馬	桓	文威
王雯	王	雯	慶祥
黃鍾	黃	鍾	孟陽
屈祥	屈	祥	天祥
李和	李	和	本中
王一夔	王	一夔	大韶
李永通	李	永通	貫道
鄭環	鄭	環	瑤夫
吳英	吳	英	邦俊
祁順	祁	順	致和
王徽	王	徽	尚文
潘禮	潘	禮	嘉會
楊繹	楊	繹	宗嗣
黃孔昭 	黃	孔昭 	世顯
朱賢	朱	賢	從善
楊瑛	楊	瑛	希玉
張元禎	張	元禎	廷祥
呂鳳	呂	鳳	好儀
陳選	陳	選	士賢
張鼐	張	鼐	堯臣
黃景隆	黃	景隆	升叔
沈暉	沈	暉	時暘
徐傅	徐	傅	起巖
凌鎬	凌	鎬	叔京
阮文英	阮	文英	和父
周巽	周	巽	敬用
周鳳	周	鳳	文祥
諸正	諸	正	養蒙
吳宣	吳	宣	彥明
劉恭	劉	恭	敬之
李溫	李	溫	景和
陳峻	陳	峻	秀民
紀欽	紀	欽	敬之
潘稹	潘	稹	景澂
徐懷	徐	懷	明德 
徐鑑	徐	鑑	克明
汪諧	汪	諧	伯諧
林同	林	同	進卿
張廷綸	張	廷綸	允言
江豫	江	豫	孟震
王震	王	震	文豫
張謹	張	謹	文謹
周正方	周	正方	可大
沈鍾	沈	鍾	仲律
王璠	王	璠	文璵
王誼	王	誼	克正
劉健	劉	健	希賢
司福	司	福	希謙
涂觀	涂	觀	恒孚
任璽	任	璽	廷信
張盛	張	盛	克謙
李諤	李	諤	尚默
陳表	陳	表	士章
葉公大	葉	公大	純仁
孫瑜	孫	瑜	孟脩
國泰 	國	泰 	時雍
黃瑮	黃	瑮	玉輝
姜璉	姜	璉	廷器
張悅	張	悅	時敏
曹英	曹	英	文華
周經	周	經	伯常
郭經	郭	經	用常
胡涇	胡	涇	源潔
劉琛	劉	琛	獻之
張玘	張	玘	士玉
馬孝祖	馬	孝祖	德源
李宗羨	李	宗羨	齊賢
項澄	項	澄	秉泓
蕭凱	蕭	凱	虞佐
項文泰 	項	文泰 	應奎
余璞 	余	璞 	良玉
方泌	方	泌	繼源
鄭紀	鄭	紀	廷綱
范鍈	范	鍈	彥俊
潘瑄 	潘	瑄 	廷璽
趙繕	趙	繕	希成
徐瓚	徐	瓚	天錫
張子言	張	子言	允嘉
陳輝	陳	輝	文耀
常顯	常	顯	道明
閻恕 	閻	恕 	行仁
王濬	王	濬	文深
郝冕	郝	冕	世瞻
周宗智	周	宗智	子正
謝潤	謝	潤	德澤
王應奎	王	應奎	文徵
鄧本端	鄧	本端	崇正
周銓	周	銓	秉衡
涂棐	涂	棐	伯輔
葉盛	葉	盛	景陽
侯英	侯	英	世傑
婁芳 	婁	芳 	永譽 
孫佐	孫	佐	時相
李廷美	李	廷美	廷美
沈熊	沈	熊	文瑞
宋黻	宋	黻	景章
邵琮	邵	琮	叔璋
劉驥	劉	驥	德良
劉賓	劉	賓	廷臣
張珇 	張	珇 	廷紳
楊瑩	楊	瑩	大潔
艾福	艾	福	天錫
王範	王	範	子儀
王塤	王	塤	宗器
張同	張	同	祖年
辜顓	辜	顓	主敬
丘霽	丘	霽	時雍
陳煒	陳	煒	文曜
饒欽	饒	欽	克恭
李雄	李	雄	文偉
王哲	王	哲	文明
談經	談	經	天章
秦夔	秦	夔	廷韶
何廣	何	廣	博之
胡澄	胡	澄	永清
王聰	王	聰	師德　
馮俊	馮	俊	士彥
南釗	南	釗	□
張溥	張	溥	彥愽
張賑	張	賑	弘濟
汪貴	汪	貴	士達
戴濬	戴	濬	文哲
盛侅	盛	侅	汝愚
谷琰	谷	琰	邦器
徐演	徐	演	文敷
陳相 	陳	相 	廷輔
薛世晅	薛	世晅	惟焯
楊德	楊	德	務本
鄭賢	鄭	賢	時舉
林清源	林	清源	用清
童璲	童	璲	思振
滕霄	滕	霄	鳳翔
王甫	王	甫	君美
金愉	金	愉	和之
李臨安 	李	臨安 	邦治
劉釗	劉	釗	時勉
聞景輝	聞	景輝	日彰
張倫	張	倫	大倫
王綸 	王	綸 	廷言
陳奎	陳	奎	文璧
邢珫	邢	珫	伯玉
劉澄	劉	澄	端本　
韓廣	韓	廣	道洪
劉元	劉	元	仁甫
陳維裕	陳	維裕	饒初　
范英	范	英	文華
張瓉	張	瓉	宗器
王霽	王	霽	景明
馮遵	馮	遵	宗轍
彭昭 	彭	昭 	景輝
秦崇	秦	崇	智崇
張頤	張	頤	養正
蔡霖	蔡	霖	洪濟
李銳	李	銳	文盛
楊庭芳 	楊	庭芳 	孟仁
趙銳	趙	銳	毅之
劉哲	劉	哲	光哲
杜亨	杜	亨	時泰
汪寬	汪	寬	汝中
王璽	王	璽	大用
郭昇	郭	昇	騰霄
彭教	彭	教	敷五
吳釴	吳	釴	鼎儀
羅璟	羅	璟	明仲
李東陽	李	東陽	賓之
劉恒	劉	恒	公誠
陳遷	陳	遷	漢崇
錢鉞	錢	鉞	大用
盧璣	盧	璣	舜用
尚冕	尚	冕	徙周
孫蕃	孫	蕃	維翰
張敷華	張	敷華	公實
周源	周	源	德淵
傅實	傅	實	璨輝
李汝嘉	李	汝嘉	士美
趙弘	趙	弘	弘遵
鄭銘	鄭	銘	德新
敖和	敖	和	正樂
姚璧	姚	璧	良甫
鄭玉	鄭	玉	時周
姚綬	姚	綬	公綬
楊智	楊	智	思明
陳稶	陳	稶	仲芳
王讓	王	讓	謙光
倪輔	倪	輔	良弼
左燁	左	燁	仲輝
陳讓	陳	讓	德光
戴春	戴	春	景元
李冕	李	冕	文中
閔珪	閔	珪	朝瑛
陳政	陳	政	以正
倪岳	倪	岳	舜咨
唐盛	唐	盛	士隆
劉懷經	劉	懷經	叔理
謝鐸	謝	鐸	鳴治
蕭禎	蕭	禎	彥祥
高斐	高	斐	文著
沈棨	沈	棨	元節
周重	周	重	如鼎
陸廣	陸	廣	德宏
范潤	范	潤	時澤
郭璽	郭	璽	文瑞
焦芳	焦	芳	孟陽
趙侃	趙	侃	至剛
胡恭	胡	恭	克敬
唐仁	唐	仁	秉元
孫義	孫	義	以方
許章	許	章	廷冕
彭序	彭	序	昭倫
趙勝	趙	勝	廷伸
虞瑤	虞	瑤	邦瓊
潘琚	潘	琚	廷用
陳清	陳	清	廉夫
李迪	李	迪	用吉
梁謹	梁	謹	敬之
汪洋	汪	洋	文淵
丘弘	丘	弘	寬叔
龔膺	龔	膺	維善
潘汝輔	潘	汝輔	汝弼
陳音	陳	音	師召
周瑄	周	瑄	良璧
張謹	張	謹	慎之
汪鎡	汪	鎡	時用
雷澤	雷	澤	時霖
杜嶠	杜	嶠	宗岳
章甫	章	甫	弘冕
吳原	吳	原	道本
黃熙	黃	熙	汝明
俞澤	俞	澤	益之
余璽	余	璽	世用
郭瑞	郭	瑞	鳳禎
鄧山	鄧	山	繼申
張鸞	張	鸞	冲舉
翟瑄	翟	瑄	廷瑞
陳壯	陳	壯	直夫
伍希淵	伍	希淵	孟賢
周鑑	周	鑑	孔明
蕭彥莊	蕭	彥莊	彥莊
葉琦	葉	琦	廷圭
張達	張	達	時達
李進	李	進	廷用
計禮	計	禮	汝和
楊琅	楊	琅	朝重
傅瀚	傅	瀚	曰川
胡深	胡	深	以道
王璒	王	璒	器之
袁鎬	袁	鎬	□
王崇	王	崇	尚德
洪清	洪	清	惟直
丁川	丁	川	大容
王軾	王	軾	用敬
吳宏密	吳	宏密	慎夫
楊恭	楊	恭	克敬
阮玘	阮	玘	廷用
趙綱	趙	綱	振紀
侯祥	侯	祥	元吉
馬暶	馬	暶	德明
段譽	段	譽	德實
姜浩	姜	浩	希孟
劉大夏	劉	大夏	時雍
劉時斆	劉	時斆	用行
曾鑑	曾	鑑	克明
楊成	楊	成	□王
鄭恭	鄭	恭	思敬
李勳	李	勳	茂烈
鄭觀	鄭	觀	建中
徐志文	徐	志文	大華
陳英	陳	英	朝彥
郭緝經	郭	緝經	屢常
樊貴	樊	貴	永德
張玘	張	玘	廷玉
周賓	周	賓	觀光
官榮	官	榮	志仁
陳仕寶	陳	仕寶	景賢
姜諒	姜	諒	用貞
朱清	朱	清	熙之
王琮	王	琮	文玉
陳按	陳	按	朝舉
張珏	張	珏	聯璧
閻佐	閻	佐	文輔
翁信	翁	信	誠之
戴玉	戴	玉	德潤
陜茂	陜	茂	本深
沈瑄	沈	瑄	廷璧
姚俊	姚	俊	用章
劉熙劭	劉	熙劭	克宣
申安	申	安	仲舒
杜懋	杜	懋	大勉
汪杲	汪	杲	廷輝
張泰	張	泰	亨父
董綸	董	綸	誠之
唐震	唐	震	孔亨
陳道	陳	道	德脩
王臣	王	臣	尚忠
張文曜	張	文曜	暉吉
蕭鼎	蕭	鼎	伯鉉
陶璽	陶	璽	廷用
李宗達	李	宗達	時望
劉珙	劉	珙	廷獻
傅允	傅	允	克誠
王詔	王	詔	文振
劉仁	劉	仁	元善
陳達	陳	達	廉善
劉道	劉	道	從理
夏景	夏	景	時中
陳賓	陳	賓	朝用
李衍	李	衍	尚文
張順	張	順	裕之
馬驄	馬	驄	德良
陳嘉言	陳	嘉言	用之
梁璟	梁	璟	廷美
聶友良	聶	友良	益之
周觀	周	觀	民表
王昭	王	昭	克明
張鐸	張	鐸	廷用
吳檟	吳	檟	大用
鄭准	鄭	准	孟川
黃澄	黃	澄	□之
龐瑄	龐	瑄	廷玉
魏容	魏	容	尊儀
戴珊	戴	珊	廷珍
陳宏	陳	宏	丕道
余志	余	志	志學
王銓	王	銓	宗衡
陳輊	陳	輊	弘載
聶蒙昌	聶	蒙昌	德隆
楊振	楊	振	廷□
吳伯通	吳	伯通	原明
金忠	金	忠	尚義
戴賓	戴	賓	邦彥
劉鈍	劉	鈍	望脩
馮貫	馮	貫	大用
李芳	李	芳	時芳
薛綱	薛	綱	之綱
曹卿	曹	卿	廷爵
毛鸃	毛	鸃	廷瑞
劉淳	劉	淳	尚質
呂昇	呂	昇	明遠
鄧球	鄧	球	廷鳴
蕭璿	蕭	璿	子璣
康玠	康	玠	廷圭
胡克勤	胡	克勤	舜臣
虞諒	虞	諒	以貞
林璧	林	璧	廷美
孫緝	孫	緝	繼号
石玉	石	玉	大器
樊瑩	樊	瑩	廷璧
毛志	毛	志	尚忠
張九疇	張	九疇	天錫
沈源	沈	源	澄之
莫昌	莫	昌	隆遠
袁江	袁	江	自岷
武清	武	清	源潔
袁晟	袁	晟	仲昭
王崇之	王	崇之	守節
曹銓	曹	銓	秉衡
費臻	費	臻	時和
林榮	林	榮	孟仁
何恦	何	恦	至廉
官廉	官	廉	汝清
閻讓	閻	讓	以實
鄧鉉	鄧	鉉	文鼎
袁玘	袁	玘	廷玉
洪性	洪	性	萬善
李琮	李	琮	義方
董齡	董	齡	壽卿
汪進	汪	進	希顏
夏時	夏	時	用寅
高岡	高	岡	鳴鳳
馬誠	馬	誠	純夫
梁翰	梁	翰	宗文
蕭器用	蕭	器用	廷瑞
曹宏	曹	宏	維裕
薛禥	薛	禥	元吉
葉贄	葉	贄	崇禮
龔晟	龔	晟	德輝
俞藎	俞	藎	廷臣
林誠	林	誠	貴實
何珣	何	珣	□瑞
溫琮	溫	琮	廷瑞
于大節	于	大節	守正
柳彰	柳	彰	廷顯
張璡	張	璡	廷玉
李鳴鳳	李	鳴鳳	時陽
張文昭	張	文昭	應奎
馮續	馮	續	承宗
陳仲舒	陳	仲舒	希賢
許盛	許	盛	昌世
王衡	王	衡	宗銓
邵奎	邵	奎	文明
邢幹	邢	幹	秉中
林玭	林	玭	廷珍
徐珪	徐	珪	國信
譚慶	譚	慶	宗善
陳昭	陳	昭	育民
劉濬	劉	濬	淵深
吳希賢	吳	希賢	希賢
趙文	趙	文	孟章
馬愈	馬	愈	柳之
於寬	於	寬	德裕
史芳	史	芳	世馨
朱萱	朱	萱	樹之
鄭節	鄭	節	從儉
劉俊	劉	俊	時用
江純	江	純	希文
郭鼎	郭	鼎	玉鉉
翁遂	翁	遂	允威
朱謙	朱	謙	益之
羅倫	羅	倫	應魁
程敏政	程	敏政	克勤
陸簡	陸	簡	廉伯
季琮	季	琮	天球
顏瑄	顏	瑄	寶之
林瀚	林	瀚	亨大
劉鈺	劉	鈺	世美
過璘	過	璘	大璞
鄺文	鄺	文	載道
張鼎	張	鼎	大器
包文	包	文	載道
張黻	張	黻	致美
羅明	羅	明	文昭
石渠	石	渠	翰卿
林克賢	林	克賢	一中
朱鐸	朱	鐸	文鳴
婁謙	婁	謙	克讓
張弼	張	弼	汝弼
張文	張	文	存簡
章懋	章	懋	德懋
陳鶴	陳	鶴	在皋
張琳	張	琳	天瑞
賀欽	賀	欽	克恭
楊廷貴	楊	廷貴	汝弼
鮑克寬	鮑	克寬	栗之
舒清	舒	清	本直
畢宗賢	畢	宗賢	士希
李傑	李	傑	世賢
王玶	王	玶	信之
錢山	錢	山	靜夫
翟瑛	翟	瑛	廷光
徐容	徐	容	文量
楊理	楊	理	貫之
張淵	張	淵	宗本
陳岳	陳	岳	孟中
江璞	江	璞	伯溫
彭善	彭	善	彥積
柳琰	柳	琰	邦用
俞俊	俞	俊	舜卿
徐完	徐	完	用美
吳玉	吳	玉	廷獻
詹雨	詹	雨	天澤
陸淵之	陸	淵之	克深
畢用	畢	用	廷用
林鳳	林	鳳	應道
李錦	李	錦	尚絅
黃仲昭	黃	仲昭	仲昭
謝文祥	謝	文祥	元吉
戴縉	戴	縉	子容
葉廷榮	葉	廷榮	尚本
林敷	林	敷	從寬
鄭昱	鄭	昱	時暉
張敏	張	敏	志學
楊溥	楊	溥	公溥
徐九思	徐	九思	一卿
薛為學	薛	為學	志淵
李瑢	李	瑢	廷章
諸觀	諸	觀	民瞻
戴僖	戴	僖	大節
張誥	張	誥	汝欽
畢瑜	畢	瑜	廷珩
張玉	張	玉	廷瓚
鄒襲	鄒	襲	繼芳
趙珤	趙	珤	德用
林孟和	林	孟和	汝和
魏景釗	魏	景釗	大用
龐常	龐	常	秉彜
梅愈	梅	愈	宗韓
劉策	劉	策	尚謨
陳廷璉	陳	廷璉	宗器
張岫	張	岫	九雲
王宗彜	王	宗彜	表倫
朱文環	朱	文環	文珮
勞玭	勞	玭	汝明
宋應奎	宋	應奎	爾章
吳禋	吳	禋	克誠
邵有良	邵	有良	維貞
吳志	吳	志	味道
商良臣	商	良臣	懋衡
羅信佳	羅	信佳	邦彥
潘禎	潘	禎	應昌
陳蕙	陳	蕙	國英
侯恂	侯	恂	誠之
李元	李	元	修德
鄭已	鄭	已	□修
丘俊	丘	俊	漢英
周翰	周	翰	良弼
曾麒	曾	麒	祥兆
萬繡	萬	繡	公錦
張海	張	海	文淵
齊章	齊	章	應璧
余祈繁	余	祈繁	汝盛
金鼒	金	鼒	公器
王輔	王	輔	時佐
談俊	談	俊	時英
徐莊	徐	莊	敬夫
張鈍	張	鈍	壽夫
孔舉	孔	舉	舜卿
高弼	高	弼	良佐
馬岱	馬	岱	伯瞻
柯燉	柯	燉	在亨
劉煊	劉	煊	用光
張正	張	正	中立
邵智	邵	智	廷鑑
張謙	張	謙	益之
江孟綸	江	孟綸	廷敘
邢謹	邢	謹	汝敬
馬震	馬	震	啓東
魏秉	魏	秉	執中
傅希說	傅	希說	商佐
陳琦	陳	琦	粹之
方輅	方	輅	洪載
王進	王	進	藎臣
江泝	江	泝	本達
劉鎡	劉	鎡	伏時
劉瑀	劉	瑀	汝器
張靜	張	靜	安之
魏政	魏	政	以德
何淳	何	淳	尚質
游佐	游	佐	汝弼
胡敬	胡	敬	文恭
朱漢	朱	漢	景雲
孫敬	孫	敬	一之
蕭龍	蕭	龍	宜中
章鎰	章	鎰	元益
李觀	李	觀	時容
何純	何	純	惟一
劉簡	劉	簡	惟嚴
董旻	董	旻	子仁
柳淳	柳	淳	文粹
高崧	高	崧	鍾秀
吳世榮	吳	世榮	克仁
顧福	顧	福	天錫
徐恪	徐	恪	公肅
周原學	周	原學	希古
蕭謙	蕭	謙	有終
崔縉	崔	縉	縉紳
熊繡	熊	繡	汝明
胡智	胡	智	尚明
吳俊	吳	俊	時用
成實	成	實	廷秀
李紳	李	紳	縉卿
芮畿	芮	畿	維瞻
袁禎	袁	禎	貞吉
林正	林	正	克全
楊祥	楊	祥	孟禎
龍伯	龍	伯	廷魁
吳潤	吳	潤	公澤
薛恭	薛	恭	士容
郭進	郭	進	用之
莊昶	莊	昶	孔暘
韓鏞	韓	鏞	文亮
任英	任	英	光弼
陳璉	陳	璉	邦貴
趙杲	趙	杲	德輝
桂廷圭	桂	廷圭	公瑞
萬山	萬	山	壽夫
李斆	李	斆	克成
東思忠	東	思忠	進伯
屠滽	屠	滽	朝宗
吳文元	吳	文元	善長
董韜	董	韜	廷顯
譚公望	譚	公望	周佐
管昌	管	昌	世隆
張瑋	張	瑋	汝器
張泰	張	泰	叔亨
江弘濟	江	弘濟	本深
陸潤	陸	潤	昌澤
強珍	強	珍	廷貴
翁晏	翁	晏	宗海
傅鼐	傅	鼐	天和
周旋	周	旋	元吉
林堉	林	堉	克茂
劉本	劉	本	尚文
康文	康	文	載道
范珠	范	珠	嘉龍
李釗	李	釗	勉之
張傑	張	傑	朝用
張蕙	張	蕙	廷芳
黃璉	黃	璉	汝器
段正	段	正	以中
尚敬	尚	敬	宗禮
余統	余	統	承之
丘山	丘	山	安重
唐寬	唐	寬	栗夫
譚昪	譚	昪	公照
湯滌	湯	滌	新之
王賓	王	賓	用之
黃本	黃	本	喬嶽
李紀	李	紀	用修
王浩	王	浩	德宏
王繼	王	繼	述之
王濬	王	濬	克深
謝寧	謝	寧	安世
曹鼐	曹	鼐	國用
蘇盛	蘇	盛	文盛
王相	王	相	樂用
程宏	程	宏	毅夫
陳惠	陳	惠	啟順
楊峻	楊	峻	維高
胡琮	胡	琮	文德
楊守隨	楊	守隨	惟貞
劉璋	劉	璋	廷圭
劉魁	劉	魁	士元
鍾晟	鍾	晟	美宣
方昇	方	昇	起東
馮寧	馮	寧	靖之
鍾蕃	鍾	蕃	庭芳
徐英	徐	英	文華
黎福	黎	福	天興
鄒儒	鄒	儒	宗魯
張進祿	張	進祿	天錫
羅睿	羅	睿	文哲
林廷庸	林	廷庸	廷庸
王昶	王	昶	必照
蕭蒼	蕭	蒼	承表
戴中	戴	中	師中
徐輝	徐	輝	孔昭
王俊	王	俊	世英
戴用	戴	用	廷獻
翟庭蕙	翟	庭蕙	秀夫
徐博	徐	博	德宏
黃寯	黃	寯	世用
劉璟	劉	璟	時瑩
張時謹	張	時謹	惟厚
呂讚	呂	讚	廷揚
馬綸	馬	綸	大綸
沈海	沈	海	觀瀾
陳筞	陳	筞	嘉謨
陳潭	陳	潭	孟明
許進	許	進	季升
余金	余	金	貢之
吳黼	吳	黼	成章
李冲	李	冲	騰霄
劉寅	劉	寅	叔亮
胡熙	胡	熙	宗文
余康	余	康	時清
劉喬	劉	喬	述憲
鄧杞	鄧	杞	邦用
嚴裕	嚴	裕	克寬
石淮	石	淮	宗海
李珪	李	珪	廷器
孫偉	孫	偉	廷彥
劉瓚	劉	瓚	庭璧
張善吉	張	善吉	本謙
王遜	王	遜	謙之
陳誼	陳	誼	子宜
劉讓	劉	讓	遜之
端澄	端	澄	本清
黃伯垓	黃	伯垓	鵬遠
蕭潤	蕭	潤	仁恩
文澍	文	澍	汝霖
鄧珙	鄧	珙	弘中
吳璋	吳	璋	文瓚
錢珍	錢	珍	廷貴
劉鉞	劉	鉞	廷肅
余瓚	余	瓚	宗震
顏格	顏	格	宗正
南鵬	南	鵬	騰霄
王琮	王	琮	德潤
袁端	袁	端	宗正
劉肅	劉	肅	敬之
林符	林	符	朝信
羅經	羅	經	大常
張鳳	張	鳳	時禎
徐舟	徐	舟	楫之
劉晟	劉	晟	孔昭
劉忠	劉	忠	顯仁
徐霖	徐	霖	用濟
李廷章	李	廷章	子純
鄧冕	鄧	冕	朝儀
乙瑄	乙	瑄	崇璧
陳清	陳	清	育之
王達	王	達	德孚
馮錤	馮	錤	時用
張賁	張	賁	彥質
白思明	白	思明	睿之
王璿	王	璿	宗舜
唐章	唐	章	宗明
馬自然	馬	自然	思勉
張瓛	張	瓛	敬修
張廉	張	廉	惟潔
馬駉	馬	駉	克毅
李顯	李	顯	道彰
郭鏜	郭	鏜	子聲
王俁	王	俁	大用
汪洪	汪	洪	克容
華秉彜	華	秉彜	天性
余英	余	英	邦毓
李敬	李	敬	成學
梁鏞	梁	鏞	克宣
張介	張	介	廉夫
劉吉和	劉	吉和	中節
李昱	李	昱	孟晹
韓文	韓	文	貫道
郝珙	郝	珙	廷璧
張廉	張	廉	孟介
張澍	張	澍	道濟
陳義	陳	義	集義
李轍	李	轍	由道
陳鼐	陳	鼐	宗調
戴祐	戴	祐	元吉
王億	王	億	用哲
馬琴	馬	琴	廷宣
李芳	李	芳	德馨
汪直	汪	直	懋儉
余琰	余	琰	公佩
楊徽	楊	徽	舜美
蔣昺	蔣	昺	克明
王義	王	義	循理
佀鐘	佀	鐘	大器
莫諲	莫	諲	如敬
沈浩	沈	浩	惟廣
甄希賢	甄	希賢	士勉
崔廷圭	崔	廷圭	國信
李文中	李	文中	宗道
汪奎	汪	奎	文燦
羅珦	羅	珦	用誠
陳鼎	陳	鼎	孟安
孫安	孫	安	勉之
施純	施	純	彥厚
李聰	李	聰	士達
柯漢	柯	漢	時昭
袁魯訓	袁	魯訓	宗道
藺澄	藺	澄	文濂
戴璉	戴	璉	廷獻
何濟	何	濟	汝舟
沃頖	沃	頖	文淵
葉稠	葉	稠	端泰
戴仁	戴	仁	以德
柳演	柳	演	宗疇
魏富	魏	富	重禮
李珊	李	珊	廷珍
楊榮	楊	榮	士仁
王弼	王	弼	良輔
李士實	李	士實	若虛
楊宣	楊	宣	浚明
徐霖	徐	霖	洪霑
趙禎	趙	禎	汝吉
劉俊	劉	俊	君佐
張寬	張	寬	伯仁
晏輅	晏	輅	邦制
金澤	金	澤	德潤
李能	李	能	時舉
區正	區	正	本中
蔣誼	蔣	誼	宗誼
王偉	王	偉	文魁
陶永淳	陶	永淳	質夫
黃傑	黃	傑	士英
張昇	張	昇	啟昭
丁溥	丁	溥	原敬
董越	董	越	尚矩
張璲	張	璲	廷佩
費誾	費	誾	廷言
陳珷	陳	珷	德章
張習	張	習	企翱
李秉衷	李	秉衷	德夫
舒春	舒	春	景熙
陳揆	陳	揆	季同
白玢	白	玢	宗璞
鄭宏	鄭	宏	元之
樂宣	樂	宣	繼諧
蕭璵	蕭	璵	煥如
梁澤	梁	澤	汝霖
王纓	王	纓	用清
言芳	言	芳	宗本
李延	李	延	與齡
王瑞	王	瑞	良璧
閻仲實	閻	仲實	光甫
尹龍	尹	龍	舜臣
尚絅	尚	絅	美中
龔澤	龔	澤	時濟
郝志義	郝	志義	宜之
鄒儒	鄒	儒	宗道
馮蘭	馮	蘭	佩之
邵宗	邵	宗	以道
郁庠	郁	庠	從周
徐冔	徐	冔	以質
吳珵	吳	珵	元玉
李蕙	李	蕙	德馨
張忱	張	忱	伯恂
毛松齡	毛	松齡	喬年
黃麟	黃	麟	文祥
喬維翰	喬	維翰	師召
楊光溥	楊	光溥	文卿
張以弘	張	以弘	裕夫
鄧存德	鄧	存德	新之
徐與憲	徐	與憲	文振
楊遵	楊	遵	循德
冀綺	冀	綺	文華
張禎叔	張	禎叔	禎叔
沈銳	沈	銳	文進
周瑛	周	瑛	梁石
張錦	張	錦	尚絅
蔡晟	蔡	晟	文輝
張縉	張	縉	朝用
周孟中	周	孟中	時可
朱紳	朱	紳	儀中
解賓	解	賓	尚敬
侯方	侯	方	公矩
李元鎮	李	元鎮	元鎮
趙祥	趙	祥	夢麟
熊景	熊	景	開甫
陸奎	陸	奎	文曜
郭忠	郭	忠	廷臣
方守	方	守	宜約
王鼎	王	鼎	元勳
陳紀	陳	紀	叔振
張晟	張	晟	孟暘
胡贊	胡	贊	克襄
勒璽	勒	璽	荊玉
謝恭	謝	恭	文安
李介	李	介	守貞
王臣	王	臣	世賞
陳勉	陳	勉	自勉
屠勳	屠	勳	元勳
崔陞	崔	陞	廷進
姜英	姜	英	時俊
鄭齡	鄭	齡	夢齡
沈璐	沈	璐	廷瑞
劉憲	劉	憲	文綱
邵珪	邵	珪	文敬
昝誠	昝	誠	篤學
吳瓊	吳	瓊	懷德
吳珉	吳	珉	廷振
周政	周	政	尚德
奚昌	奚	昌	元啟
張曉	張	曉	光曙
李經	李	經	大經
瞿俊	瞿	俊	世用
高安	高	安	曰恭
梅江	梅	江	文淵
尹仁	尹	仁	性之
謝秉中	謝	秉中	惟時
楊惇	楊	惇	載夫
李璡	李	璡	純夫
劉忠器	劉	忠器	世用
楊重	楊	重	質夫
宋經	宋	經	大經
陳耀	陳	耀	孔彰
劉福	劉	福	天祐
何舜賓	何	舜賓	穆之
朱瑄	朱	瑄	廷璧
臧瓊	臧	瓊	文瑞
李崙	李	崙	世瞻
王廷	王	廷	朝用
謝綱	謝	綱	振倫
堯卿	堯	卿	廷輔
包謙	包	謙	益之
莊恭	莊	恭	儀甫
陸珩	陸	珩	節行
金爵	金	爵	良貴
王珣	王	珣	德潤
張純	張	純	仕和
林璞	林	璞	□中
卲猷	卲	猷	陳之
汪正	汪	正	惟中
許暠	許	暠	宗寅
梁萬鍾	梁	萬鍾	天錫
邵新	邵	新	復初
胡璘	胡	璘	汝溫
張淮	張	淮	邦鎮
韓邦問	韓	邦問	大經
李晟	李	晟	孔暘
沈純	沈	純	一之
李景繁	李	景繁	邦泰
宋驥	宋	驥	德遠
李茂	李	茂	世榮
張和	張	和	宗禮
陳雲鳳	陳	雲鳳	儀之
趙杲	趙	杲	廷輝
廖德徵	廖	德徵	德徵
張銳	張	銳	退之
雍泰	雍	泰	世隆
馬隆	馬	隆	世昌
江源	江	源	一原
黃景	黃	景	文昭
鄒霶	鄒	霶	濟時
陳寓	陳	寓	時安
何鑑	何	鑑	世光
劉規	劉	規	應乾
張鏞	張	鏞	大器
徐鏞	徐	鏞	用和
范聰	范	聰	達善
熊翀	熊	翀	騰霄
林和	林	和	恒肅
李鑑	李	鑑	孔昭
李謙	李	謙	吉甫
方岳	方	岳	恒謙
鄭諒	鄭	諒	廷察
雷升	雷	升	大亨
李昊	李	昊	志遠
李延壽	李	延壽	宗仁
王儼	王	儼	民望
孫仁	孫	仁	偉德
王溥	王	溥	公甫
王舟	王	舟	弘載
李恭	李	恭	思敬
高銓	高	銓	宗選
唐絹	唐	絹	世用
黃著	黃	著	誠夫
葉亨	葉	亨	叔通
趙艮	趙	艮	時中
談綱	談	綱	憲章
王京	王	京	宗周
曹時中	曹	時中	時中
陳遵毅	陳	遵毅	貴弘
楊謐	楊	謐	文寧
賀霖	賀	霖	時望
張穀	張	穀	伯祿
李良	李	良	堯臣
劉灌	劉	灌	惠民
孫中	孫	中	時中
林樞	林	樞	邦拱
黃文琰	黃	文琰	宗器
陳忠	陳	忠	孝卿
蔡元美	蔡	元美	子仁
俞祿	俞	祿	從學
黃韶	黃	韶	九成
嚴賓	嚴	賓	邦賢
陳鑑	陳	鑑	德熙
鄒騏	鄒	騏	良甫
劉長春	劉	長春	存仁
許楫	許	楫	公濟
董安	董	安	敦仁
周熊	周	熊	世祥
王錦	王	錦	絅之
戴瑤	戴	瑤	仲儀
李釗	李	釗	孟遠
張翊	張	翊	廷弼
李恭	李	恭	致敬
周蕃	周	蕃	世昌
王坦	王	坦	彥平
劉瓊	劉	瓊	德溫
蔡肅	蔡	肅	克恭
熊佑	熊	佑	良佐
徐瑁	徐	瑁	廷璧
龔沅	龔	沅	孔殷
楊澄	楊	澄	憲父
陳鯉	陳	鯉	騰龍
羅元吉	羅	元吉	大昌
董通	董	通	彥達
陳密	陳	密	存義
劉昂	劉	昂	廷舉
奚昊	奚	昊	時亨
李鏡	李	鏡	文明
徐謙	徐	謙	伯亨
姜天錫	姜	天錫	祐之
丁鏞	丁	鏞	鳳儀
李俊	李	俊	子英
何俊	何	俊	廷彥
葉祚	葉	祚	應福
李鸞	李	鸞	廷儀
徐瓚	徐	瓚	國用
柳應辰	柳	應辰	拱之
陳鳳	陳	鳳	文瑞
周郁	周	郁	文盛
毛泰	毛	泰	時亨
張璁	張	璁	廷璧
姚倫	姚	倫	大倫
祝瀾	祝	瀾	有本
王玹	王	玹	邦器
李進	李	進	時勉
鮑麒	鮑	麒	仲瑞
樊經	樊	經	大經
朱守孚	朱	守孚	中孚
邵暉	邵	暉	日昭
張衎	張	衎	敬先
方珪	方	珪	純潔
盧瑀	盧	瑀	希玉
鄭宏	鄭	宏	德崇
顧竑	顧	竑	惟遠
吳傑	吳	傑	廷臣
蕭冕	蕭	冕	廷冕
徐傑	徐	傑	民望
顧佐	顧	佐	良弼
李濬	李	濬	德深
薛珪	薛	珪	廷器
董榮	董	榮	廷寵
彭朗	彭	朗	遐霽
郭銓	郭	銓	秉衡
齊文	齊	文	應奎
李㵾	李	㵾	士清
姜宣	姜	宣	德敷
劉瓛	劉	瓛	廷珍
謝顯	謝	顯	時榮
鄭炯	鄭	炯	叔亮
王問	王	問	好學
張倫	張	倫	宗道
吳祚	吳	祚	天保
蕭定	蕭	定	文靜
吳瓌	吳	瓌	仲偉
林表	林	表	廷儀
劉源	劉	源	汝潔
趙聰	趙	聰	時憲
解敏	解	敏	克聰
吳寬	吳	寬	原博
劉震	劉	震	道亨
李仁傑	李	仁傑	士奐
邵賢	邵	賢	用之
劉輔	劉	輔	相之
張瑾	張	瑾	廷玉
卞諲	卞	諲	寅之
張祥	張	祥	思履
吳裕	吳	裕	敬昆
張黻	張	黻	兼素
翟通	翟	通	任亨
謝理	謝	理	一卿
楊榮	楊	榮	時秀
李繸	李	繸	時器
梁方	梁	方	惟義
鍾鏞	鍾	鏞	朝用
蕭奎	蕭	奎	漢文
馬鉉	馬	鉉	孔任
潘璋	潘	璋	栗夫
高昂	高	昂	尊卿
金源	金	源	大本
陰子淑	陰	子淑	宗孟
王參	王	參	拱辰
鄧焯	鄧	焯	廷昭
彭禮	彭	禮	彥恭
蔣容	蔣	容	德夫
葉睦	葉	睦	敬之
李孟暘	李	孟暘	時雍
蕭本容	蕭	本容	德弘
陳洵	陳	洵	匯之
張琡	張	琡	文璧
任彥常	任	彥常	吉夫
董寧	董	寧	伯康
黃東山	黃	東山	世瞻
王宜	王	宜	益亨
陳瑗	陳	瑗	大玉
陳以忠	陳	以忠	孟藎
彭載	彭	載	孔載
方彬	方	彬	文中
簡顯	簡	顯	齊道
林㙱	林	㙱	世調
陳謨	陳	謨	師禹
林濬淵	林	濬淵	用淵
黃榮	黃	榮	儼仁
茅鋐	茅	鋐	大用
陳壽	陳	壽	本仁
周軫	周	軫	公載
湯全	湯	全	完之
朱本	朱	本	立行
陳哲	陳	哲	繼昭
顧餘慶	顧	餘慶	崇善
楊澤	楊	澤	商霖
李震	李	震	時亨
蕭顯	蕭	顯	文明
洪廷臣	洪	廷臣	以道
孟述	孟	述	景賢
鄧林	鄧	林	廷棟
周季麟	周	季麟	公瑞
達毅	達	毅	士弘
瞿明	瞿	明	德昭
趙蘭	趙	蘭	廷綺
范絪	范	絪	太和
王宏	王	宏	仲裕
杜學	杜	學	時敏
趙璧	趙	璧	藺完
沈鎧	沈	鎧	仲威
張昞	張	昞	時顯
吳文度	吳	文度	憲之
張鳳騫	張	鳳騫	鳴岐
陳謙	陳	謙	天益
王祿	王	祿	政夫
黃謙	黃	謙	撝之
閭鉦	閭	鉦	靜之
許輔	許	輔	佐之
李序	李	序	大倫
邵敏	邵	敏	汝學
高敞	高	敞	德廣
江漢	江	漢	紀南
濮晉	濮	晉	用昭
張憲	張	憲	廷式　
胡超	胡	超	彥超
白坦	白	坦	易之
司馬垔	司馬	垔	通伯
汪山	汪	山	仁夫
柳豸	柳	豸	廷直
袁道	袁	道	德純
吳憲	吳	憲	肅清
賀元忠	賀	元忠	澤民
趙潤	趙	潤	良玉
李寅	李	寅	敬之
衛邦	衛	邦	翰之　
唐鼐	唐	鼐	宗器
李燁	李	燁	文暉
俞俊	俞	俊	尚賢
張佶	張	佶	習之
王輔	王	輔	良弼
項旻	項	旻	崇仁
陳孜	陳	孜	勉學
朱守恕	朱	守恕	尚仁
褚祚	褚	祚	昌胤
吳凱	吳	凱	廷輔
陳瑤	陳	瑤	仲華
饒裕	饒	裕	仁作
桂鎬	桂	鎬	宗周
章銳	章	銳	元進
李翰章	李	翰章	文卿
張英	張	英	尚實
馬孔惠	馬	孔惠	孝卿
陳裕	陳	裕	孟寬
陳璧	陳	璧	瑞卿
孫弁	孫	弁	文冕
顧純	顧	純	以正
譚宗泗	譚	宗泗	文淵
何鐘	何	鐘	廷宣
朱欽	朱	欽	懋恭
宋端	宋	端	民表
曾拱辰	曾	拱辰	朝極
吳溥	吳	溥	公濟
趙文盛	趙	文盛	從周
陳軒	陳	軒	廷策
劉紳	劉	紳	宗儒
張稷	張	稷	世用
黃熒	黃	熒	敦實
蘭玉	蘭	玉	廷章
沈瓌	沈	瓌	彥器
任穀	任	穀	生之
劉宇	劉	宇	志大
吳哲	吳	哲	克明
李瑛	李	瑛	廷輝
孟瀛	孟	瀛	宗淵
張昺	張	昺	仲明
閻琮	閻	琮	廷珍
陳觀	陳	觀	尚賓
周茂	周	茂	時雍
王雄	王	雄	鎮遠
彭銓	彭	銓	大用
楊維	楊	維	憲維
錢玉	錢	玉	德輝
許斌	許	斌	廷佐
汪箎	汪	箎	仲和
高昇	高	昇	明遠
王肅	王	肅	崇恭
程普	程	普	克濟
馮廣	馮	廣	永公
易鶚	易	鶚	九霄
章武	章	武	繼韶
吳泰	吳	泰	昌期
謝綱	謝	綱	廷憲
文林	文	林	宗儒
方顯	方	顯	孔融
游興	游	興	用賓
歐瑄	歐	瑄	廷璧
陸淵	陸	淵	子澄
朱贊	朱	贊	光輔
陳金	陳	金	汝礪
朱福	朱	福	天錫
李珉	李	珉	美中
趙英	趙	英	儲秀
淩昇	淩	昇	鵬舉
林泮	林	泮	用養
樂宗茂	樂	宗茂	景德
傅金	傅	金	汝礪
崔俊	崔	俊	世英
張瑛	張	瑛	德輝
吳郁	吳	郁	文盛
黃寬	黃	寬	汝栗
劉鳳翔	劉	鳳翔	德輝
王璟	王	璟	廷采
孫需	孫	需	孚吉
陳英	陳	英	廷賢
林清	林	清	源□
何瀞	何	瀞	源清
華清	華	清	濂卿
李勤	李	勤	時勉
李諒	李	諒	友信
楊一清	楊	一清	應寧
朱仲炘	朱	仲炘	德輝
胡漢	胡	漢	源梁
王佐	王	佐	良弼
俞璣	俞	璣	廷美
董紱	董	紱	嗣章
徐廣	徐	廣	居仁
羅贊	羅	贊	世卿
張清	張	清	澄源
陳理	陳	理	民彜
吳珙	吳	珙	廷瑞
李瀛	李	瀛	宗澤
郝隆	郝	隆	景昌
李孟晊	李	孟晊	時泰
張廷綱	張	廷綱	朝振
喬縉	喬	縉	廷儀
李復貞	李	復貞	明實
羅元祥	羅	元祥	宗瑞
余鐸	余	鐸	文振
靳睿	靳	睿	希顏
馬鑑	馬	鑑	文煥
奚銘	奚	銘	克新
陳福	陳	福	宗範
樊金	樊	金	公礪
強滿	強	滿	克謙
揭魁	揭	魁	士元
胡榮	胡	榮	邦顯
金舜臣	金	舜臣	汝弼
李隆	李	隆	世昌
馮沉	馮	沉	榮端
程春震	程	春震	時舉
林貴	林	貴	良貴
姜昂	姜	昂	恒頫
王勉	王	勉	時藎
陳塏	陳	塏	汝陵
鄺頤	鄺	頤	惟貞
王紳	王	紳	縉卿
王弁	王	弁	世瞻
李暹	李	暹	伯暘
鄭頀	鄭	頀	汝諧
宋嶽	宋	嶽	紹申
徐節	徐	節	時中
羅九鼎	羅	九鼎	象州
管麟	管	麟	文禎
陳嘉謨	陳	嘉謨	良顯
李雲	李	雲	載章
呂炯	呂	炯	文昭
馬驄	馬	驄	伯良
董彜	董	彜	克明
趙炯	趙	炯	文鑑
楊仲倫	楊	仲倫	宗理
洪漢	洪	漢	天章
王經	王	經	允常
王暄	王	暄	時暘
朱慶雲	朱	慶雲	奇逄
鄧庠	鄧	庠	宗周
楊純	楊	純	彥誠
洪漢	洪	漢	朝宗
劉懋	劉	懋	勉之
胡縉	胡	縉	曰紳
彭恭	彭	恭	敬之
吳玉榮	吳	玉榮	世重
吳智	吳	智	汝哲
張雄	張	雄	文偉
沈瑬	沈	瑬	伯玉
張撫	張	撫	世安
薛真	薛	真	大正
吳琳	吳	琳	廷章
倪鏞	倪	鏞	廷器
王佐	王	佐	君卿
國志虞	國	志虞	宗舜
李寬	李	寬	克寬
丘璐	丘	璐	仲玉
董綱	董	綱	萬紀
方全	方	全	用周
謝遷	謝	遷	于喬
劉戩	劉	戩	景元
王鏊	王	鏊	濟之
卜同	卜	同	從大
徐洪	徐	洪	公溥
洪鍾	洪	鍾	宣之
金楷	金	楷	式之
王沂	王	沂	希曾
郭定	郭	定	靜之
楊茂元	楊	茂元	志仁
楊仕偉	楊	仕偉	景奇
劉忠	劉	忠	臣節
吳倬	吳	倬	克大
張銳	張	銳	抑之
華山	華	山	仁甫
王傅	王	傅	良弼
仰昇	仰	昇	進卿
陳謨	陳	謨	嘉猷
程廷珙	程	廷珙	獻之
吳欽	吳	欽	禹鄰
彭經	彭	經	載道
馬中錫	馬	中錫	添祿
鄭重	鄭	重	本弘
王鍃	王	鍃	文曜
伍希閔	伍	希閔	仲孝
雷士栴	雷	士栴	元芳
童潮	童	潮	信之
范吉	范	吉	以貞
陳相	陳	相	子鄰
左悠	左	悠	尚遠
孫裕	孫	裕	德宏
葉盛	葉	盛	昌伯
陳珍	陳	珍	廷貴
元守直	元	守直	良弼
吳珍	吳	珍	汝貴
吳誠	吳	誠	性夫
吳洪	吳	洪	禹疇
蘇章	蘇	章	文簡
陳綬	陳	綬	公佩
李哲	李	哲	彥明
楊棨	楊	棨	大拯
史俊	史	俊	邦彥
馬璠	馬	璠	廷璽
曹元	曹	元	以貞
李雲	李	雲	時望
袁宏	袁	宏	德宏
趙鶴齡	趙	鶴齡	永年
王嶽	王	嶽	仰嵩
彭綱	彭	綱	性仁
劉紳	劉	紳	大章
張本	張	本	孟端
毛倫	毛	倫	秉彜
廖中	廖	中	用中
章玄應	章	玄應	順德
周宏	周	宏	懋德
黃鐸	黃	鐸	文器
俞經	俞	經	勉誠
盧鴻	盧	鴻	雄飛
尹珍	尹	珍	廷用
徐源	徐	源	仲山
江貴	江	貴	公輔
陸遠	陸	遠	德毅
劉杲	劉	杲	世熙
和暲	和	暲	文輝
任文遂	任	文遂	思順
耿文睿	耿	文睿	天資
吳瑞	吳	瑞	德徵
諸讓	諸	讓	養和
趙恩	趙	恩	允仁
王盛	王	盛	懋德
畢亨	畢	亨	嘉會
魯誠	魯	誠	文明
秦瓛	秦	瓛	廷贄
朱愷	朱	愷	舜徵
楊奉春	楊	奉春	世元
王敏	王	敏	遜之
汪鳳	汪	鳳	天瑞
吳愈	吳	愈	惟謙
姚昺	姚	昺	懋明
吳嵩	吳	嵩	中立
劉時	劉	時	本升
冒政	冒	政	有恒
陸怡	陸	怡	順之
黃鉞	黃	鉞	廷威
劉定昌	劉	定昌	邦泰
周鳳	周	鳳	文明
趙明	趙	明	孔昭
潘祺	潘	祺	應昇
潘洪	潘	洪	裕夫
劉鵬	劉	鵬	圖南
楊杲	楊	杲	孟暉
許弼	許	弼	佑之
童柷	童	柷	勉和
周盈	周	盈	謙之
童蘭	童	蘭	世馨
樓東	樓	東	啟明
管達	管	達	升逵
王懋	王	懋	勉之
張琛	張	琛	獻之
余琦	余	琦	世徵
王臯	王	臯	舜臣
俞振才	俞	振才	振才
吳轍	吳	轍	宗正
吳仲珠	吳	仲珠	純夫
李㵝	李	㵝	源潔
趙泰	趙	泰	時雍
向翀	向	翀	九霄
宋宣	宋	宣	世達
劉瓚	劉	瓚	國用
戈瑄	戈	瑄	廷玉
武清	武	清	源潔
文瑞	文	瑞	應祥
蕭惠	蕭	惠	順成
馮衡	馮	衡	平叔
黃玹	黃	玹	敬潤
楊璡	楊	璡	用章
藍洪	藍	洪	宗浩
曹英	曹	英	世傑
曹瀾	曹	瀾	文源
胡英	胡	英	廷俊
任泰	任	泰	亨伯
韓明	韓	明	惟遠
徐同愛	徐	同愛	仁夫
李興	李	興	伯起
佟珍	佟	珍	時貴
田畊	田	畊	濟民
鄭錡	鄭	錡	威甫
余順	余	順	天助
吳綱	吳	綱	廷振
鄭克昭	鄭	克昭	克昭
王有恬	王	有恬	德安
盧勗	盧	勗	汝成
孫軻	孫	軻	希賢
田禋	田	禋	本誠
堵昇	堵	昇	文旭
沈振	沈	振	克成
俞深	俞	深	濬之
周儀	周	儀	熙模
陳嵩	陳	嵩	仰之
樂鏞	樂	鏞	聲遠
史書	史	書	獻忠
齊廷珪	齊	廷珪	朝重
唐韶	唐	韶	尚虞
余鐖	余	鐖	懋器
劉綸	劉	綸	大本
董復	董	復	德初
楊鈺	楊	鈺	廷璽
潘隆	潘	隆	逢吉
魏璋	魏	璋	廷圭
周宗	周	宗	繼先
吳福	吳	福	吉甫
吳穀	吳	穀	子玉
淩寀	淩	寀	熙載
葉琛	葉	琛	廷獻
郭綸	郭	綸	理之
王瑭	王	瑭	良玉
陳景隆	陳	景隆	如初
陳經	陳	經	貫之
張鼎	張	鼎	宗器
孔斌	孔	斌	時憲
張宏	張	宏	克容
林淮	林	淮	長深
鄭欽	鄭	欽	尚敬
劉信	劉	信	朋節
李楫	李	楫	時濟
陳祥	陳	祥	吉夫
謝富陽	謝	富陽	仕春
周木	周	木	近仁
郭秩	郭	秩	持倫
張廣	張	廣	弘仁
施裕	施	裕	克寬
陳熊	陳	熊	祥孟
黎經	黎	經	允正
何珖	何	珖	汝玉
陸愈	陸	愈	抑之
陳琚	陳	琚	宗玉
周洪	周	洪	寬夫
王傅	王	傅	舜臣
孫賓	孫	賓	敬之
何善	何	善	惟吉
李思明	李	思明	原晦
蹇霆	蹇	霆	克遂
黃乾亨	黃	乾亨	汝亨
宋德	宋	德	世隆
錢承德	錢	承德	世恒
華仲賢	華	仲賢	廷佐
胡瀛	胡	瀛	孟登
李行	李	行	遵化
李旻	李	旻	仁甫
王琰	王	琰	良璧
向榮	向	榮	至德
王舉	王	舉	時用
朱洪	朱	洪	宗海
紀傑	紀	傑	士英
閻仲宇	閻	仲宇	參甫
郭珙	郭	珙	元圭
陳奐	陳	奐	朝美
陳懋源	陳	懋源	懋源
陳忠	陳	忠	思敬
顏涇	顏	涇	澄之
方陟	方	陟	文進
張瓚	張	瓚	器之
李琨	李	琨	德嘉
趙年	趙	年	有年
湯鼐	湯	鼐	用之
袁鳳	袁	鳳	朝陽
田孔昭	田	孔昭	德明
趙琮	趙	琮	彥玉
劉傅	劉	傅	師正
郭紳	郭	紳	廷章
唐相	唐	相	希愷
吳珏	吳	珏	孟璋
王嵩	王	嵩	邦鎮
文貴	文	貴	天爵
張穀	張	穀	濟民
鄒魯	鄒	魯	公輔
秦蕃	秦	蕃	良翰
繆樗	繆	樗	全之
蕭謙	蕭	謙	子豫
陳鉞	陳	鉞	汝威
魏琮	魏	琮	廷玉
王弼	王	弼	存敬
張玉林	張	玉林	邦輝
袁士鳳	袁	士鳳	彥祥
朱瓚	朱	瓚	朝用
何鈞	何	鈞	仲衡
馬通	馬	通	文達
張璟	張	璟	廷璧
馮義	馮	義	宜之
劉愷	劉	愷	伯和
張貫	張	貫	一之
張賓	張	賓	廷賓
張西銘	張	西銘	希載
王宬	王	宬	容之
金章	金	章	相用
胡棨	胡	棨	信之
李尚達	李	尚達	尚達
倫善	倫	善	國寶
陳睿	陳	睿	邦獻
滑浩	滑	浩	宗源
唐昭	唐	昭	文煥
馮允中	馮	允中	信道
吳淑	吳	淑	艾夫
李德恢	李	德恢	叔恢
李毓	李	毓	鍾秀
趙讓	趙	讓	元遜
海澄	海	澄	靜之
張鼐	張	鼐	用和
雷以時	雷	以時	用中
王僑	王	僑	德高
曾䡵	曾	䡵	文載
賀思聰	賀	思聰	時敏
周冕	周	冕	文中
柯忠	柯	忠	與節
石瑭	石	瑭	廷堅
張輔	張	輔	允忠
張勛	張	勛	紀常
李輝	李	輝	永燦
張穟	張	穟	世美
李遜	李	遜	敬之
林元甫	林	元甫	元甫
劉璟	劉	璟	德輝
黃錀	黃	錀	世美
徐海	徐	海	鉅夫
黎鼎	黎	鼎	汝重
楊傑	楊	傑	獻夫
唐瑢	唐	瑢	玉潤
趙溥	趙	溥	以周
劉英	劉	英	廷用
李參	李	參	宿卿
陳轂	陳	轂	推士
吳珍	吳	珍	朝重
馬昆	馬	昆	克昌
林資	林	資	性初
郭資	郭	資	逢源
王珩	王	珩	美器
毛鳳來	毛	鳳來	應成
王華	王	華	廷光
張雄	張	雄	鵬飛
費瑄	費	瑄	仲玉
車明理	車	明理	宗道
陳讓	陳	讓	遜之
陳天元	陳	天元	宗仁
張超	張	超	能達
白忠	白	忠	舜臣
李智	李	智	宗哲
盛德	盛	德	克修
王儼	王	儼	若思
趙繡	趙	繡	希錦
馬銓	馬	銓	秉衡
閻倫	閻	倫	天敘
李魁	李	魁	士元
田景賢	田	景賢	宗儒
潘盛	潘	盛	世隆
劉清	劉	清	孔廉
張源潔	張	源潔	希白
秦昇	秦	昇	叔熙
周啟	周	啟	應文
戚昂	戚	昂	時望
陳倫	陳	倫	攸敘
曾彥	曾	彥	士美
楊守阯	楊	守阯	惟立
曾追	曾	追	文甫
梁儲	梁	儲	叔厚
吳雄	吳	雄	□□
戴豪	戴	豪	師文
朱臨 	朱	臨 	時進
沈繼先	沈	繼先	述之
唐斆	唐	斆	與學
傅凱	傅	凱	時舉
楊文卿	楊	文卿	質夫
黎復登	黎	復登	繼之
黃翼之	黃	翼之	廷相
張澯	張	澯	仲湜
周璁	周	璁	潤夫
王楫	王	楫	洪濟
毛科	毛	科	應奎
王欽	王	欽	敬之
周淵	周	淵	本深
陳璚	陳	璚	玉汝
楊傑	楊	傑	廷俊
革從時	革	從時	用中
孫衍	孫	衍	世延
蔡相	蔡	相	元鼎
劉紀	劉	紀	振之
劉質	劉	質	曰彬
許英	許	英	文傑
戈孜	戈	孜	勉學
畢孝	畢	孝	宗仁
林俊	林	俊	待用
吳昭	吳	昭	守愚
張綱	張	綱	萬善
敖山	敖	山	靜之
紀振	紀	振	文聲
徐佑	徐	佑	允吉
劉濂	劉	濂	宗周
蔣泰	蔣	泰	道亨
劉忠	劉	忠	□直
劉濟	劉	濟	澤民
伍性	伍	性	宗誠
周鵬	周	鵬	萬里
伊乘	伊	乘	□戴
吳紀	吳	紀	堙之
孫珪	孫	珪	廷用
陳琬	陳	琬	仲廉
周紘	周	紘	仲瞻
于材	于	材	國用
趙璧	趙	璧	潤夫
王珦	王	珦	克溫
劉允中	劉	允中	叔彜
田鐸	田	鐸	振之
姚紹	姚	紹	廷述
李德美	李	德美	克美
陳震	陳	震	大亨
沈元	沈	元	善之
高鑑	高	鑑	克明
孫春	孫	春	一元
馮珏	馮	珏	□玉
張璞	張	璞	韞玉
李韶	李	韶	克諧
陳粟	陳	粟	惠民
袁弼	袁	弼	世臣
楊鼐	楊	鼐	傑和
陳章	陳	章	一夔
虞臣	虞	臣	元凱
張約	張	約	文博
林殿	林	殿	世南
嚴永濬	嚴	永濬	宗哲
張耀	張	耀	隱之
吳裕	吳	裕	克寬
徐鵬	徐	鵬	大游
李泰	李	泰	叔通
劉昭	劉	昭	大章
馮忠	馮	忠	原孝
姚綸	姚	綸	嗣道
周鵬	周	鵬	雲翔
汪藻	汪	藻	文潔
賈定	賈	定	仲一
林璿	林	璿	衡玉
林昊	林	昊	思欽
羅安	羅	安	時泰
鄧焲	鄧	焲	廷耀
羅鑒	羅	鑒	緝熙
吳超	吳	超	華越
黃文琳  	黃	文琳  	潤玉
江瀾	江	瀾	文瀾
繆昌 	繆	昌 	廷謨
孫博  	孫	博  	約之
張九功	張	九功	敘之
熊祿	熊	祿	曰貴
周信 	周	信 	□誠
龍騰霄	龍	騰霄	時夫
郭宗	郭	宗	宗魯
車璽	車	璽	一之
宋禮	宋	禮	惟寅
趙昂 	趙	昂 	天鳳
劉則和	劉	則和	至樂
沙璧	沙	璧	廷玉
錢鑑 	錢	鑑 	□□
包鼎 	包	鼎 	汝調
宋明	宋	明	惟遠
宋琮 	宋	琮 	□□
周榮 	周	榮 	□□
張韶 	張	韶 	九成
宗鉞 	宗	鉞 	廷威
李祥 	李	祥 	□善
陳邦瑞 	陳	邦瑞 	五端
馬廷用 	馬	廷用 	良佐
林　榮	林	　榮	仲仁
朱悌 	朱	悌 	舜敏
許璘 	許	璘 	文玉
林則方 	林	則方 	正夫
葛萱 	葛	萱 	□庭
蕭集	蕭	集	懋成
曹璘	曹	璘	廷輝
余完 	余	完 	□美
丁璣 	丁	璣 	玉大
荊茂	荊	茂	庭春
王本儉  	王	本儉  	節之
王建  	王	建  	成中
聞人珇 	聞	人珇 	德夫
黃鍾  	黃	鍾  	伯祿
吳湜 	吳	湜 	一清
汪舜民  	汪	舜民  	從仁
沈清  	沈	清  	願夫
趙榮	趙	榮	永實
劉翔	劉	翔	九霄
劉琬	劉	琬	德資
李楘	李	楘	□賓
歐陽復 	歐陽	復 	孟亨
丁隆 	丁	隆 	時雍
蒲鋼 	蒲	鋼 	南金
王宏 	王	宏 	仲廣
暢亨 	暢	亨 	文通
賈錠 	賈	錠 	良金
李華  	李	華  	子實
丁佑	丁	佑	□之
劉憲	劉	憲	廷式
高璁	高	璁	潤之
孫珩 	孫	珩 	邦玉
鄒賢	鄒	賢	世用
丁積 	丁	積 	彥誠
丁昶  	丁	昶  	德輝
周仲芳	周	仲芳	繼遠
錢清	錢	清	宗源
朱昂	朱	昂	廷舉
陳寬	陳	寬	裕夫
鍾雅	鍾	雅	大章
李德仁	李	德仁	季仁
陳綺 	陳	綺 	于章
鄭珏 	鄭	珏 	廷貴
周南 	周	南 	文化
李政 	李	政 	以德
管通  	管	通  	彥亨
錢鏞 	錢	鏞 	用聲
姜洪 	姜	洪 	希範
劉珩 	劉	珩 	文鳴
過鶴 	過	鶴 	九皋
孫紘	孫	紘	文冕
馮瑢	馮	瑢	時鳴
陳烓	陳	烓	文用
連盛 	連	盛 	文昌
張倫	張	倫	天敘
陳文玉  	陳	文玉  	德輝
徐以貞 	徐	以貞 	本良
任弘	任	弘	伯容
何悌 	何	悌 	順卿
王倬 	王	倬 	用檢
吳球	吳	球	玉甫
顧達  	顧	達  	存遺
張繼 	張	繼 	述之
胡富  	胡	富  	永年
鄭傑 	鄭	傑 	□□
蘇泰  	蘇	泰  	文亨
呂渭 	呂	渭 	惟清
蔣蕃	蔣	蕃	邦憲
黃節甫	黃	節甫	□
徐綱 	徐	綱 	廷憲
趙瑛	趙	瑛	廷光
魯義 	魯	義 	□宜
許潛  	許	潛  	□□
劉機  	劉	機  	世衡
王屏 	王	屏 	惟昇
張澤 	張	澤 	苑民
胡諒 	胡	諒 	允□
袁慶祥 	袁	慶祥 	德徵
張冕 	張	冕 	服周
楊縉  	楊	縉  	廷紳
蔣廷貴	蔣	廷貴	元用
鍾瓘	鍾	瓘	良玉
杜瑄 	杜	瑄 	懷玉
劉纓	劉	纓	與清
劉彬 	劉	彬 	素□
李經 	李	經 	士常
王鯨	王	鯨	大升
涂昇	涂	昇	卿儀
張泰	張	泰	世亨
李儼 	李	儼 	仲威
曹玉	曹	玉	德潤
林時潤 	林	時潤 	德溫
張璉 	張	璉 	□器
朱寰 	朱	寰 	德充
陳崇 	陳	崇 	德崇
劉嶽 	劉	嶽 	仰止
鄭仁憲 	鄭	仁憲 	□□
周洪 	周	洪 	廷誥
陳亮	陳	亮	志明
李瓚	李	瓚	廷玉
陳鉞	陳	鉞	廷□
茆欽 	茆	欽 	宗堯
管琪  	管	琪  	儒珍
何文縉 	何	文縉 	德章
許坦	許	坦	□□
謝文	謝	文	道顯
王和	王	和	以節
張芮  	張	芮  	文卿
王鉉 	王	鉉 	伯舉
才寬	才	寬	汝栗
鄧概	鄧	概	冠節
劉廷瓚 	劉	廷瓚 	宗敬
包裕	包	裕	好問
房明 	房	明 	廷耀
夏崇文	夏	崇文	廷章
蕭英	蕭	英	文俊
龔弘 	龔	弘 	元之
倪進賢 	倪	進賢 	秉忠
張璄 	張	璄 	孟輝
熊達 	熊	達 	成章
李暹 	李	暹 	□□
王汶 	王	汶 	允達
周源 	周	源 	子濬
明經 	明	經 	致用
宋鑑 	宋	鑑 	□明
楊廷和 	楊	廷和 	介夫
牛通 	牛	通 	道亨
劉洪 	劉	洪 	希範
吳世騰 	吳	世騰 	伯起
宋漢 	宋	漢 	天章
汪宗禮	汪	宗禮	敬夫
陳瑞	陳	瑞	廷圭
趙寬  	趙	寬  	德宏
丁鍊 	丁	鍊 	質純
孫識	孫	識	以蓄
呂 璋	呂	 璋	廷圭
周□	周	□	克禮
康厚	康	厚	本淳
章忱 	章	忱 	景恂
李善	李	善	宗元
楊時暢	楊	時暢	知休
王相 	王	相 	君卿
韓鎬 	韓	鎬 	民瞻
杜桓	杜	桓	八德
吳道寧 	吳	道寧 	□□
張罍 	張	罍 	元器
王進 	王	進 	以正
董豫	董	豫	德和
韋斌  	韋	斌  	□質
周弁	周	弁	時制
杜忠	杜	忠	世臣
史効	史	効	廷忠
褚潭 	褚	潭 	濬之
劉遜 	劉	遜 	時讓
葉應 	葉	應 	子唯
施恕	施	恕	勉仁
夏祚 	夏	祚 	天錫
武衛  	武	衛  	廷脩
馬龍 	馬	龍 	文祥
翟能	翟	能	本善
李增	李	增	廷重
白瑾 	白	瑾 	瑩之
王鑑之  	王	鑑之  	明仲
王存禮	王	存禮	用和
周濬 	周	濬 	希源
蘇鏸 	蘇	鏸 	仲戡
吳文	吳	文	載道
周敍 	周	敍 	天敘
高綸 	高	綸 	廷章
蔣欽	蔣	欽	世欽
張經	張	經	天常
張翬 	張	翬 	鳳舉
胡溥 	胡	溥 	□博
謝珪	謝	珪	允執
馬琇 	馬	琇 	天須
馬懋 	馬	懋 	昭德
鮮榮 	鮮	榮 	居仁
徐禮 	徐	禮 	敬先
熊經	熊	經	載道
史瑛	史	瑛	廷珍
尹陵	尹	陵	如阜
張晟	張	晟	宗晦
包鼐 	包	鼐 	汝和
黃頤 	黃	頤 	養德
李瑞 	李	瑞 	世祥
鄭達 	鄭	達 	德孚
黃肅 	黃	肅 	敬夫
杜整  	杜	整  	思齊
劉芳 	劉	芳 	永□
汪貴 	汪	貴 	良貴
譚溥	譚	溥	惟淵
龍德周 	龍	德周 	躬□
唐愷	唐	愷	虞卿
王賓 	王	賓 	時暘
王溫 	王	溫 	景和
王朝器	王	朝器	大器
徐說 	徐	說 	以中
韓昂 	韓	昂 	孔儀
吳秀 	吳	秀 	文朴
王謙  	王	謙  	克讓
方進	方	進	繼□
譚肅 	譚	肅 	本恭
戚慶 	戚	慶 	仲禧
劉清 	劉	清 	一之
劉璣 	劉	璣 	玉衡
張萬鍾	張	萬鍾	公爵
陳良佐 	陳	良佐 	以忠
汪瀅 	汪	瀅 	源潔
鄭璠 	鄭	璠 	德美
魏璽 	魏	璽 	朝章
陳嘉章	陳	嘉章	道顯
陳紋 	陳	紋 	廷章
尹世昌	尹	世昌	廷□
劉聰  	劉	聰  	宇愚
鄭惟桓 	鄭	惟桓 	用文
祁司員 	祁	司員 	宗□
姜綰 	姜	綰 	玉卿
洪遠	洪	遠	克毅
侯觀 	侯	觀 	仕賓
杜榮 	杜	榮 	世□
杜明	杜	明	文昭
黃輔政 	黃	輔政 	顯忠
涂疇 	涂	疇 	有年
陳常 	陳	常 	大倫
周文 	周	文 	應奎
韓紹宗	韓	紹宗	裕俊
吳道寧 	吳	道寧 	永安
徐憲 	徐	憲 	振綱
李時新 	李	時新 	節之
韓重	韓	重	淳夫
趙博	趙	博	原一
丁紳 	丁	紳 	大章
金福 	金	福 	天錫
凌文獻 	凌	文獻 	士賢
馮鎬 	馮	鎬 	大京
古其然  	古	其然  	體成
張鑑	張	鑑	明□
王佐	王	佐	廷輔
胡靖	胡	靖	光大
王艮	王	艮	欽止
李貫	李	貫	子學
吳溥   	吳	溥   	德潤
朱塔	朱	塔	梯雲
楊子榮	楊	子榮	勉仁
金幼孜	金	幼孜	幼孜
劉現	劉	現	朝紳
何仕讓	何	仕讓	仕讓
曾芑	曾	芑	子田
郇旃	郇	旃	惟進
方孚	方	孚	叔達
鄧時俊	鄧	時俊	時俊
梁成	梁	成	成性
張禮聞	張	禮聞	來學
陳繼之	陳	繼之	以行
吳福	吳	福	好德
李敬	李	敬	仲寅
顧斌	顧	斌	彥才
劉福	劉	福	天祉
楊溥   	楊	溥   	弘濟
黃宗晦	黃	宗晦	克復
陳道潛	陳	道潛	孔昭
蔣簡	蔣	簡	恒廉
葉福	葉	福	叔疇
傅行	傅	行	德方
馮貴	馮	貴	孟敬
王高	王	高	彥高
李時	李	時	宜中
鄧亮	鄧	亮	子信
熊文綬	熊	文綬	藻伯
商惠	商	惠	原逵
朱原貞	朱	原貞	季行
周銓	周	銓	文衡
陳義生	陳	義生	用質
黃鉞	黃	鉞	叔楊
胡濙	胡	濙	源潔
宋彥名	宋	彥名	子謙
雷填	雷	填	原中
萬忠	萬	忠	居敬
秦鳳	秦	鳳	子儀
顧詳	顧	詳	文約
應履平	應	履平	錫祥
潘文奎	潘	文奎	景昭
李敦	李	敦	處厚
張聰	張	聰	達夫
鄧槐	鄧	槐	大材
何穎	何	穎	仲實
潘義	潘	義	思義
劉復	劉	復	性初
陳獻	陳	獻	景賢
吳琬	吳	琬	德圭
林洪	林	洪	文範
黃重	黃	重	孟剛
黃胤宗	黃	胤宗	胤宗
王能	王	能	克用
尹惟忠	尹	惟忠	遂良
席杲	席	杲	特初
王彝	王	彝	秉彝
劉壽愻	劉	壽愻	叔順
熊又成	熊	又成	性善
齊政	齊	政	用衡
郭秩	郭	秩	惇禮
閻濟	閻	濟	汝舟
嚴升	嚴	升	仲升
曹嗣宗	曹	嗣宗	益顯
劉綱	劉	綱	文紀
劉得	劉	得	彥本
任壇	任	壇	廷堅
盧廣	盧	廣	彥高
李瑀	李	瑀	從善
陳綬	陳	綬	章美
徐新	徐	新	德新
劉虬	劉	虬	公潛
鄭鎬	鄭	鎬	仲京 
劉永	劉	永	思遠
楊渤	楊	渤	啔隆
唐吉祥	唐	吉祥	彥禎
陳善	陳	善	之敬
汪翁綬	汪	翁綬	文若
劉迪簡	劉	迪簡	邁生
蔣驥	蔣	驥	良夫
葉瑄	葉	瑄	文珙
陳賓	陳	賓	文獻
童銓	童	銓	士衡
李寅	李	寅	克敬
王郁	王	郁	文愽
薛東	薛	東	希震
唐復	唐	復	永亨
俞本	俞	本	景立
王政	王	政	彥貞
李謙	李	謙	子讓
韓禎	韓	禎	惟祥
蕭潭	蕭	潭	孟南
余灝	余	灝	泰熙
耿直	耿	直	彥正
石彥成	石	彥成	性衷
黃宜	黃	宜	子儀
黃諒	黃	諒	子貞
黃思敬	黃	思敬	公儼
孫讓	孫	讓	克恭
余存諒	余	存諒	誠之
顧佐	顧	佐	
顧謙	顧	謙	仲謙
孫完	孫	完	孟學
馬驤	馬	驤	致遠
武斌	武	斌	希文
帥用昌	帥	用昌	汝陽
馬彜	馬	彜	秉彝
李泰	李	泰	安然
王華	王	華	德輝
黃珣	黃	珣	廷璽
張天瑞	張	天瑞	天祥
胡玉	胡	玉	伯堅
程文 	程	文 	貫道
宋端儀	宋	端儀	孔時
鄭瑗	鄭	瑗	仲璧
胡璟	胡	璟	希宋
東思誠	東	思誠	進道
楊奇	楊	奇	秀夫
陳秉彞	陳	秉彞	一初
趙寬	趙	寬	栗夫
張瓚	張	瓚	廷器
孫交	孫	交	志同
喻宗府	喻	宗府	孔脩
歐銳	歐	銳	時毅
薛英	薛	英	朝英
魏紳	魏	紳	廷佩
原潔	原	潔	本澄
劉紹玄	劉	紹玄	顯之
駱瓏	駱	瓏	蘊良
江潭	江	潭	朝東
郭祥鵬	郭	祥鵬	于漢
沈林	沈	林	材美
陳效	陳	效	志學
王機	王	機	正朝
閻江	閻	江	朝宗
李旦	李	旦	啟東
張吉	張	吉	克脩
李思仁	李	思仁	尚德
胡瑄	胡	瑄	廷器
陳倫	陳	倫	用常
彭福	彭	福	綏之
談詔	談	詔	朝宣
顧雄	顧	雄	時俊
石巍	石	巍	民望
尚縉	尚	縉	美儀
常麟	常	麟	汝仁
徐寬	徐	寬	栗夫
晏轍	晏	轍	同軌
陶琰	陶	琰	廷信
艾璞	艾	璞	德潤
王濟	王	濟	汝舟
彭程	彭	程	萬里
王宥	王	宥	敬之
毛憲	毛	憲	世章
饒泗	饒	泗	正繹
彭甫	彭	甫	原嶽
翁迪	翁	迪	允吉
陳周	陳	周	文美
范珤	范	珤	惟善
王玘	王	玘	德潤
馬龍	馬	龍	汝霖
林鐄	林	鐄	世堅
周鳳	周	鳳	鳴岐
馮良輔	馮	良輔	熙之
張濂	張	濂	宗周
孫霖	孫	霖	希說
王瓚	王	瓚	宗器
趙仲輝	趙	仲輝	守中
湯冕	湯	冕	拱宸
車霆	車	霆	震卿
王琳	王	琳	廷佩
富玹	富	玹	廷輝
陳勗	陳	勗	時勉
徐貴	徐	貴	天爵
章啟	章	啟	際亨
宋旭	宋	旭	景暘
孫旵	孫	旵	愛暉
婁性	婁	性	原善
夏英	夏	英	育才
莊宥	莊	宥	世寬
劉珏	劉	珏	廷重
胡積學	胡	積學	畏之
趙渾	趙	渾	伯全
呂和	呂	和	時中
劉富	劉	富	文華
何說	何	說	商臣
方向	方	向	與義
張銓	張	銓	文衡
翁巖	翁	巖	國瞻
顧源	顧	源	逢原
邵諴	邵	諴	元侃
陳憲	陳	憲	孟章
陳義	陳	義	克宜
陳宣	陳	宣	文德
康紹宗	康	紹宗	孝隆
黃俌	黃	俌	汝脩
馬體元	馬	體元	以乾
韓鼎	韓	鼎	廷器
余洪	余	洪	崇範
吳彥華	吳	彥華	汝和
沈庠	沈	庠	尚倫
胡宗道	胡	宗道	守正
張鎧	張	鎧	廷儀
王敞	王	敞	漢英
侯直	侯	直	公繩
芮稷	芮	稷	維馨
張應奎	張	應奎	時禎
陳良器	陳	良器	彥成
孫琰	孫	琰	廷尚
姚隆	姚	隆	復亨
倪黻	倪	黻	汝辨
史簡	史	簡	公鑒
劉讓	劉	讓	允謙
許銳	許	銳	季節
謝罃	謝	罃	廷獻
郭文旭	郭	文旭	仲升
馮玘	馮	玘	良玉
林沂	林	沂	居魯
左輔	左	輔	廷弼
王寅	王	寅	敬夫
李棨	李	棨	廷信
徐諫	徐	諫	廷忠
陳良	陳	良	明遇
江澂	江	澂	景吴
王表	王	表	大章
王恩	王	恩	天寵
李澄	李	澄	天暎
吳鳳鳴	吳	鳳鳴	應文　
韓福	韓	福	德夫
張寅	張	寅	敬之
郭文 	郭	文 	尚質
吳一貫	吳	一貫	道夫
薛承學	薛	承學	志參
王定安 	王	定安 	至善
李𤣲	李	𤣲	德貞
歐陽旦 	歐陽	旦 	子相
王瑫	王	瑫	宗玉
宋守約	宋	守約	希曾
馬炳然	馬	炳然	思進
張禎	張	禎	國興
李銳	李	銳	廷鉞
陳振	陳	振	時起
蔣勛	蔣	勛	世功
程文 	程	文 	載道
侯明	侯	明	定夫
陳崇德	陳	崇德	季廣
李端	李	端	表正
孫治	孫	治	五美
胡昂	胡	昂	文謙
王璇	王	璇	虞用
湯建	湯	建	昌本
黃克守	黃	克守	守正
黃璉	黃	璉	汝器
王鼎	王	鼎	器之
張弘宜	張	弘宜	時措
余濬	余	濬	仲深
郭絍	郭	絍	仲端
蕭翀	蕭	翀	淩漢
鄧應仁	鄧	應仁	子榮
李芳	李	芳	資元
張濬	張	濬	宗舜
鄒祥	鄒	祥	元吉
樊廷選	樊	廷選	舜舉
呂卣	呂	卣	宜中
劉聚	劉	聚	本仁
葉元玉	葉	元玉	廷璽
楊綸 	楊	綸 	理之
寧賢	寧	賢	國徵
張智	張	智	守愚
張鳳 	張	鳳 	應時
陳延	陳	延	壽夫
葉預	葉	預	誠之
張烜	張	烜	伯彰
楊鍊	楊	鍊	德純
趙弼	趙	弼	廷直
劉璣	劉	璣	用齊
張祺	張	祺	允吉
李厚	李	厚	弘載
王泰	王	泰	道亨
廖鉉	廖	鉉	汝器
汪律	汪	律	用和
傅潮	傅	潮	曰會
汪僎	汪	僎	簡之
黃華	黃	華	實夫
榮華	榮	華	躬實
常新	常	新	士勉
王槐	王	槐	應禎
韓春	韓	春	時元
林堪	林	堪	舜卿
周謐	周	謐	靖之
張鸞	張	鸞	應祥
李咨	李	咨	汝弼
馬良玉	馬	良玉	德純
梁偉	梁	偉	士奇
梁鞏	梁	鞏	邦寧
王一言	王	一言	行之
張安 	張	安 	文靖
張璠	張	璠	廷用
袁燫	袁	燫	景輝
林瑭	林	瑭	廷玉
曹鳳	曹	鳳	鳴岐
張桓	張	桓	德威
梅純	梅	純	一之
曾祿	曾	祿	汝學
張寧	張	寧	元勳
張恕	張	恕	希仁
朱栻	朱	栻	良用
周應熙 	周	應熙 	郁文
李瀚	李	瀚	叔淵
姜學夔	姜	學夔	一臣
倪珏	倪	珏	文玉
吳裕	吳	裕	天弘
黃珙	黃	珙	德溫
林籥	林	籥	繼和
蔡暹	蔡	暹	文暉
劉繼	劉	繼	纉緒
汪瀚	汪	瀚	文淵
劉渙	劉	渙	濟之
何淮	何	淮	德清
魯永清	魯	永清	端本　
劉勳	劉	勳	德光
陳銓	陳	銓	秉衡
姚祥	姚	祥	應龍
龍用升	龍	用升	舜舉
熊宗德	熊	宗德	天申
丘相 	丘	相 	廷佐
賈宗錫	賈	宗錫	原善
林世遠	林	世遠	思紹
盧格 	盧	格 	正夫
何文英	何	文英	邦彥
劉道立	劉	道立	成己
黃祥	黃	祥	驗和
杜源	杜	源	永靖
儲材	儲	材	世資
廖純	廖	純	乾順
楊春	楊	春	元之
程愈	程	愈	節之
蕭義	蕭	義	宜之
田淵	田	淵	文淵
李宗泗	李	宗泗	希顏
李時	李	時	維中
鄭軾	鄭	軾	式之
鄧淮	鄧	淮	安濟
劉盛之	劉	盛之	文郁
徐欽	徐	欽	敬之
梁文 	梁	文 	光輔
顧景祥 	顧	景祥 	瑞卿
梁敬	梁	敬	德興
吳暠	吳	暠	元白
陳潤	陳	潤	維澤
楊塽	楊	塽	允昭
余絢	余	絢	公素
于鳳喈	于	鳳喈	世和
張敏	張	敏	志學
謝緝	謝	緝	維熙
葛鏞	葛	鏞	文振
王章	王	章	廷憲
王杲	王	杲	啟昭
葉巒	葉	巒	鍾秀
張宜珍	張	宜珍	汝珍
孫衍	孫	衍	世昌
許節	許	節	本儉
王嶽	王	嶽	希甫
張隆	張	隆	世昌
丘天祐	丘	天祐	恒吉
莫立之	莫	立之	斯立
竇祥	竇	祥	文瑞
張文 	張	文 	道顯
朱英	朱	英	德彰
魏英	魏	英	士華
韓庭	韓	庭	鳳集
高雲	高	雲	從龍
佘璘	佘	璘	德潤
張縉	張	縉	廷肅
周琦	周	琦	廷璽
李振綱	李	振綱	廷憲
常軏	常	軏	時用
趙鑾	趙	鑾	廷振
張閻	張	閻	宗望
汪堅	汪	堅	守貞
張琳	張	琳	廷珮
崔瓚	崔	瓚	宗器
聞釗	聞	釗	遠明
鄭寯	鄭	寯	天民
黃琪	黃	琪	文瑞
孔經	孔	經	大猷
張鑑	張	鑑	恒明
趙進	趙	進	益之
李濙	李	濙	宗禹
崔巖	崔	巖	民瞻
張昹	張	昹	孟明
徐智	徐	智	景哲
曲銳	曲	銳	朝儀
郭秉昭 	郭	秉昭 	文輝
馬祥	馬	祥	文瑞
郭緒	郭	緒	繼業
王佑	王	佑	廷佐
張佐	張	佐	良弼
王純	王	純	弘文
曹佺	曹	佺	存之
耿瑛	耿	瑛	玉光
蔣濙	蔣	濙	子川
費宏	費	宏	子充
劉春	劉	春	仁仲
涂瑞	涂	瑞	邦祥
程楷	程	楷	正之
王璽	王	璽	廷信
季源	季	源	本清
周虁	周	虁	甫敬
劉孟	劉	孟	子賢
任倫	任	倫	秉元
陳欽	陳	欽	亮之
王鴻儒	王	鴻儒	懋學
董威	董	威	德隅
楊瑛	楊	瑛	潤卿
蔣冕	蔣	冕	敬之
祝瀚	祝	瀚	惟容
謝通	謝	通	伸佑
陳鎬	陳	鎬	宗之
盧亨	盧	亨	永泰
葉紳	葉	紳	廷縉
歐鉦	歐	鉦	時振
屈伸	屈	伸	引之
蔡欽	蔡	欽	懋鄰
涂瑾	涂	瑾	邦玉
鄭宗仁	鄭	宗仁	體元
王綸	王	綸	朝言
程昊	程	昊	時亨
陳經綸	陳	經綸	汝學
袁達	袁	達	德孚
李朝陽	李	朝陽	鳴鳳
滕檳	滕	檳	秀之
孫孺	孫	孺	幼真
張贊	張	贊	希臯
賈澄	賈	澄	廉夫
彭崑	彭	崑	良玉
黃穆	黃	穆	子敬
范玶	范	玶	文潤
陳玉	陳	玉	潤夫
陳仁	陳	仁	子居
陳邦弼	陳	邦弼	惟忠
傅珪	傅	珪	邦瑞
萬弘璧	萬	弘璧	廷瑞
鄧琛	鄧	琛	貢甫
朱悳	朱	悳	懿卿
倪阜	倪	阜	舜薰
華鑾	華	鑾	伯瞻
王軒	王	軒	廷冕
萬福	萬	福	季崇
董傑	董	傑	萬英
吳儼	吳	儼	克温
趙全	趙	全	季脩
馬輿	馬	輿	良載
涂旦	涂	旦	卿元
王迪	王	迪	允吉
余徵	余	徵	弘貴
邵棠	邵	棠	民愛
錢鐸	錢	鐸	道鳴
劉約	劉	約	博之
姜麟	姜	麟	仁夫
李漢	李	漢	充昭
李文祥	李	文祥	天瑞
項經	項	經	誠之
王中	王	中	時中
楊茂仁	楊	茂仁	志道
仲棐	仲	棐	與成
毛實	毛	實	世誠
熊祥	熊	祥	文應
汪璿	汪	璿	舜璣
楊錦	楊	錦	尚絅
孟逵	孟	逵	道亨
鄧公輔	鄧	公輔	良臣
張舉	張	舉	孟賢
丁鳳	丁	鳳	應韶
方仁	方	仁	行恕
胡倫	胡	倫	天敘
周琰	周	琰	載文
馬子聰	馬	子聰	舜達
房鑑	房	鑑	宗明
盧濬	盧	濬	希哲
范慶	范	慶	天錫
李端澄	李	端澄	學溥
崔璽	崔	璽	元禎
辛禮	辛	禮	用和
羅玘	羅	玘	景鳴
壽儒	壽	儒	宗魯
胡汝礪	胡	汝礪	良弼
蘇葵	蘇	葵	伯誠
官昹	官	昹	仲昭
張景琦	張	景琦	廷良
陶纘	陶	纘	述之
楊潭	楊	潭	宗淵
曾全	曾	全	復初
徐鍵	徐	鍵	啟之
李堂	李	堂	時升
李鸞	李	鸞	天瑞
周旋	周	旋	克敬
汪鉉	汪	鉉	鼎卿
毛珵	毛	珵	貞甫
萬祥	萬	祥	世和
胡悳	胡	悳	允脩
匡翼之	匡	翼之	敬敷
許淳	許	淳	文厚
謝汝暘	謝	汝暘	晉卿
彭景	彭	景	叔大
吳鋆	吳	鋆	汝礪
史學	史	學	文鑑
程沂	程	沂	宗魯
仵紳	仵	紳	佩之
郭珠	郭	珠	明遠
曾昂	曾	昂	光表
陸完	陸	完	全卿
戴恩	戴	恩	天錫
黎臣	黎	臣	希虁
張潤	張	潤	子温
馬景昌	馬	景昌	廷言
劉麟	劉	麟	景祥
馬政	馬	政	公敏
劉淮	劉	淮	東之
魯得之	魯	得之	希曾
吉人	吉	人	惟正
韓鼐	韓	鼐	國器
劉良	劉	良	質臣
俞琳	俞	琳	德彰
魏玒	魏	玒	秉德
王緯	王	緯	廷文
袁翱	袁	翱	鳳儀
彭敷	彭	敷	汝言
沈瓚	沈	瓚	君錫
藍應	藍	應	景祥
魯昂	魯	昂	廷瞻
周亮采	周	亮采	秉臣
蔡鐸	蔡	鐸	振之
鄭炤	鄭	炤	叔昭
賈欽	賈	欽	敬之
李裕中	李	裕中	容正
趙縉	趙	縉	廷儀
丁養浩	丁	養浩	師孟
任漢	任	漢	宗海
陳瑞	陳	瑞	鳳儀
吳浚	吳	浚	淵之
謝瀚	謝	瀚	汝大
韓祜	韓	祜	天錫
林長繁	林	長繁	世殷
李珍	李	珍	相儒
鄧墇	鄧	墇	禮方
余本實	余	本實	誠之
徐文英	徐	文英	景華
張淳	張	淳	宗厚
徐紀	徐	紀	大紀
歐泰	歐	泰	子通
黃濟	黃	濟	翊時
陳世良	陳	世良	崇之
高胤先	高	胤先	世德
戴初	戴	初	復之
黃世經	黃	世經	時濟
張掖	張	掖	輔之
文森	文	森	宗嚴
虞坤	虞	坤	公載
蔣昇	蔣	昇	賓暘
白翱	白	翱	鳳儀
吳廷舉	吳	廷舉	獻臣
許暺	許	暺	景暉
李瀚	李	瀚	文博
柴昇	柴	昇	公照
朱綬	朱	綬	文佩
歐陽鵬	歐陽	鵬	時舉
伍符	伍	符	朝信
毛詩	毛	詩	大經
童寬	童	寬	濟之
翁健之	翁	健之	應乾
李遜學	李	遜學	希賢
朱輔	朱	輔	良臣
馮傑	馮	傑	秀夫
鄧頤	鄧	頤	行正
張黼	張	黼	仕欽
王恩	王	恩	克承
鄒智	鄒	智	汝愚
羅勳	羅	勳	卿積
徐鶚	徐	鶚	良舉
李葵	李	葵	朝陽
唐禎	唐	禎	原善
方天然	方	天然	𢁫誠
張嵿	張	嵿	時峻
羅政	羅	政	皆正
邢纓	邢	纓	文甫
李溥	李	溥	宗大
周鉞	周	鉞	廷儀
王鐸	王	鐸	大振
潘府	潘	府	孔脩
向時	向	時	惟中
王濟	王	濟	用楫
石寶	石	寶	□□
鄭宗載	鄭	宗載	本厚
榮節	榮	節	應中
張津	張	津	廣漢
張瀾	張	瀾	道本
張相	張	相	佐虞
王珍	王	珍	元聘
李充嗣	李	充嗣	士脩
弋福	弋	福	尚潔
徐九齡	徐	九齡	壽卿
石玠	石	玠	邦秀
倪天民	倪	天民	秀夫
和鵬	和	鵬	大舉
范伸	范	伸	邦直
杜啟	杜	啟	子開
丁榮	丁	榮	宗仁
唐希介	唐	希介	景賢
郎滋	郎	滋	德潤
胡承	胡	承	安節
王術	王	術	用仁
俞世德	俞	世德	守宗
徐紹先	徐	紹先	繼之
祝福	祝	福	德饒
陳策	陳	策	廷獻
晁盡孝	晁	盡孝	克仁
李良	李	良	遂之
陳震	陳	震	文靜
丁經	丁	經	彝之
朱智	朱	智	體貞
李鑑	李	鑑	晦之
王用	王	用	士賢
劉章	劉	章	德潤
邵遵道	邵	遵道	堯臣
胡鎬	胡	鎬	京濟
紀鏞	紀	鏞	大器
國瑀	國	瑀	朝佩
秦渙	秦	渙	汝亨
李埜	李	埜	茂林
許鵬	許	鵬	圖南
蔡杲	蔡	杲	特明
白鸞	白	鸞	孟禽
陳端	陳	端	廷表
黃玄齡	黃	玄齡	崇壽
葉清	葉	清	本澄
李璽	李	璽	德貴
趙文奎	趙	文奎	天章
鄭弘	鄭	弘	道熙
胡崋	胡	崋	惟峻
周南	周	南	化行
趙鑑	趙	鑑	克正
朱應昌	朱	應昌	會期
夏景和	夏	景和	時雍
周紀	周	紀	廷理
趙容	趙	容	德宏
金洪	金	洪	惟深
楊孟瑛	楊	孟瑛	温甫
蔣昪	蔣	昪	誠之
錢春	錢	春	應仁
毛紀	毛	紀	維之
蘇奎	蘇	奎	炳文
何顯	何	顯	繼善
任鑑	任	鑑	自明
彭瓚	彭	瓚	廷器
黃昌	黃	昌	景文
劉聦	劉	聦	達夫
方誌	方	誌	信之
林綱	林	綱	德舉
周楫	周	楫	濟之
陸崑	陸	崑	中玉
蔡餘慶	蔡	餘慶	從善
樊祉	樊	祉	介福
陳恪	陳	恪	克謹
吳必顯	吳	必顯	德純
王資良	王	資良	輔德
楊子器	楊	子器	名父
王洧	王	洧	清之
彭程	彭	程	憲卿
王秩	王	秩	循伯
謝諮	謝	諮	堯臣
蔣恭	蔣	恭	肅之
夏鍭	夏	鍭	德樹
方溢	方	溢	文晬
郝本	郝	本	立夫
蕭艮宣	蕭	艮宣	敷化
王啟	王	啟	景昭
徐詵	徐	詵	邦孚
劉丙	劉	丙	文煥
梁廷賓	梁	廷賓	尚治
張瑋	張	瑋	嘉玉
黃印	黃	印	廷章
韋厚	韋	厚	原載
王玹	王	玹	廷用
李岱	李	岱	宗岳
蔣顒	蔣	顒	思誠
曾逸	曾	逸	世超
吾應麒	吾	應麒	文瑞
朱珏	朱	珏	廷周
曹忠	曹	忠	原孝
華璉	華	璉	商器
蔣浤	蔣	浤	維深
攴夔	攴	夔	克敬
徐璘	徐	璘	文𤩹
王貫	王	貫	一之
袁佐	袁	佐	國佐
沈時	沈	時	元中
車份	車	份	允宜
王珀	王	珀	廷瑞
唐弼	唐	弼	希說
張廷珍	張	廷珍	效儒
王約	王	約	資博
陳晦	陳	晦	待徵
胡顯宗	胡	顯宗	世榮
劉泰	劉	泰	世亨
韓普	韓	普	文博
翁理	翁	理	存道
袁孟悌	袁	孟悌	本仁
任儀	任	儀	象之
閻价	閻	价	允德
姜溥	姜	溥	希廣
張拱	張	拱	朝儀
郭廷珪	郭	廷珪	邦器
王鐶	王	鐶	崇重
李隆	李	隆	世昌
牟道	牟	道	文載
楊廉	楊	廉	方震
陳懷經	陳	懷經	時濟
謝湖	謝	湖	有容
嚴禎	嚴	禎	廷瑞
馮浩	馮	浩	養正
朱璣	朱	璣	文瑞
王希旦	王	希旦	景哲
華津	華	津	濟之
潘楷	潘	楷	以正
王存忠	王	存忠	誠之
葉鋌	葉	鋌	惟剛
任良才	任	良才	廷舉
胡昂	胡	昂	時舉
張時澤	張	時澤	濟民
邢霖	邢	霖	時望
張瀾	張	瀾	東之
王琚	王	琚	良珮
胡經	胡	經	緯之
石昭	石	昭	景輝
沈淮	沈	淮	伯淵
焦韶	焦	韶	鳳儀
張鍈	張	鍈	聲遠
劉浩	劉	浩	元充
程頊	程	頊	廷臣
李性明	李	性明	誠夫
周昂	周	昂	友昂
任繼祖	任	繼祖	述之
錢灝	錢	灝	景宗
劉紳	劉	紳	佩教
邢洪	邢	洪	德裕
汪侃	汪	侃	仲和
蔡輔	蔡	輔	咨政
張瑞	張	瑞	廷信
屈霖	屈	霖	天澤
徐瑤	徐	瑤	文舟
呂鵬	呂	鵬	搏萬
熊概	熊	概	大節
錢福	錢	福	與謙
劉存業	劉	存業	可大
靳貴	靳	貴	充道
楊旦	楊	旦	晉叔
徐紘	徐	紘	朝文
汪澤	汪	澤	公溥
彭杰	彭	杰	景俊
唐貴	唐	貴	用思
張天爵	張	天爵	良貴
李昆	李	昆	承裕
寗舉	寗	舉	惟臣
吳世忠	吳	世忠	懋貞
王瑩	王	瑩	汝潔
周統	周	統	伯承
丁珮	丁	珮	大用
周序	周	序	仲禮
黃暐	黃	暐	日升
金冕	金	冕	文用
黃繡	黃	繡	文卿
李承祖	李	承祖	繼宗
陳綬	陳	綬	學之
相樞	相	樞	拱之
羅榮	羅	榮	志仁
崔儀	崔	儀	虞鳳
吳綱	吳	綱	宏舉
仲本	仲	本	與立
時中	時	中	大本
張安甫	張	安甫	汝勉
龍夔	龍	夔	舜卿
童瑞	童	瑞	世奇
胡易	胡	易	光貞
方良永	方	良永	壽卿
劉紳	劉	紳	美用
胡儀	胡	儀	士望
徐逵	徐	逵	大亨
張約	張	約	守之
張定	張	定	子靜
韓智	韓	智	愚夫
胡拱	胡	拱	惟辰
徐木	徐	木	惟喬
晁必登	晁	必登	汝吉
何宗理	何	宗理	邦治
馮夔	馮	夔	廷伯
查煥	查	煥	文顯
彭桓	彭	桓	景武
朱稷	朱	稷	相之
王惠	王	惠	吉甫
鄭淶	鄭	淶	子水
彭澤	彭	澤	濟物
李宗商	李	宗商	尚質
海鯉	海	鯉	躍之
邵蕡	邵	蕡	文實
尹灝	尹	灝	淳甫
黃顒	黃	顒	伯望
方良節	方	良節	介卿
周洪	周	洪	大猷
鄭軏	鄭	軏	行之
童琥	童	琥	廷瑞
沈衡	沈	衡	平甫
張謐	張	謐	廷佐
楊樸	楊	樸	克淳
曹詢	曹	詢	汝庸
張琮	張	琮	廷獻
官賢	官	賢	汝俊
宗佑	宗	佑	元吉
林善	林	善	體元
沙立	沙	立	道中
吳晟	吳	晟	克明
廖雲騰	廖	雲騰	□□
周炯	周	炯	堯宇
張綵	張	綵	尚質
趙瑺	趙	瑺	惟德
王彥奇	王	彥奇	庭簡
周珮	周	珮	鳴玉
陳珂	陳	珂	希白
呂濟	呂	濟	安世
俞穩	俞	穩	宅仁
項亨明	項	亨明	崇哲
周載	周	載	子坤
唐臣	唐	臣	堯佐
趙璜	趙	璜	庭實
劉鑑	劉	鑑	孔昭
林夔	林	夔	元佐
陶懌	陶	懌	習之
羅柔	羅	柔	文徽
呂傑	呂	傑	廷臣
趙履祥	趙	履祥	夫
王宸	王	宸	具瞻
劉挺	劉	挺	咸卓
吳仕偉	吳	仕偉	世美
李祿	李	祿	宗學
廖紀	廖	紀	廷陳
劉績	劉	績	用熙
祝祥	祝	祥	廷瑞
李承芳	李	承芳	茂卿
石椂	石	椂	允升
王經	王	經	文濟
尹洪	尹	洪	德容
王奎	王	奎	國文
王錦	王	錦	在中
方憲	方	憲	宜弼
陸坦	陸	坦	子由
曹玉	曹	玉	廷珮
羅列	羅	列	天爵
崔侃	崔	侃	廷直
陳珩	陳	珩	君錫
來天球	來	天球	伯韶
金山	金	山	仲仁
許翱	許	翱	鵬舉
尹琭	尹	琭	廷璽
洪鐘	洪	鐘	肇和
朱華	朱	華	素卿
王統	王	統	必元
鍾永	鍾	永	世昌
李琳	李	琳	廷貢
汪淵	汪	淵	仲深
沈冬魁	沈	冬魁	伯貞
馬繼祖	馬	繼祖	崇功
包漙	包	漙	民敬
吳潛	吳	潛	顯之
胡江	胡	江	東會
喬恕	喬	恕	希仁
楊文	楊	文	宗周
譚昇	譚	昇	時晉
俞諫	俞	諫	良佐
聶賢	聶	賢	承之
郭桂	郭	桂	時芳
宋鳳	宋	鳳	應韶
賴先	賴	先	伯啟
楊鉞	楊	鉞	威之
叢蘭	叢	蘭	廷秀
尹頌	尹	頌	慶成
陸淞	陸	淞	文東
鄧明	鄧	明	惟遠
黃傅	黃	傅	夢弼
車梁	車	梁	茂賢
袁經	袁	經	大倫
董鑰	董	鑰	啟之
王冠	王	冠	廷望
石瑽	石	瑽	德和
王凱	王	凱	文相
徐銳	徐	銳	鈍之
孫武卿	孫	武卿	仲勳
段敏	段	敏	惟勤
劉璲	劉	璲	士約
張景明	張	景明	廷光
趙欽	趙	欽	思敬
李廷儀	李	廷儀	鳴鳳
袁宗臯	袁	宗臯	仲德
劉嶤	劉	嶤	象謙
李鯨	李	鯨	騰海
李應和	李	應和	純元
鄭協	鄭	協	用中
王欽	王	欽	曰恭
趙繼宗	趙	繼宗	叔敬
王綸	王	綸	大經
徐寶	徐	寶	信之
王時中	王	時中	道夫
徐鉞	徐	鉞	用寧
鄭士忠	鄭	士忠	廷獻
范瑨	范	瑨	朝珍
熊伯通	熊	伯通	本睿
符觀	符	觀	衍觀
翁文魁	翁	文魁	希曾
鄒虞	鄒	虞	天祥
王璟	王	璟	明仲
彭誠	彭	誠	君實
莫英	莫	英	中美
孫鄘	孫	鄘	翰之
蔡鍊	蔡	鍊	懋成
丘經	丘	經	正夫
董宣	董	宣	朝用
况璟	况	璟	汝明
原秉衷	原	秉衷	天敘
劉鳳儀	劉	鳳儀	天瑞
王俸	王	俸	應爵
茹鑾	茹	鑾	世和
徐有	徐	有	若無
孫璽	孫	璽	國信
曹敬	曹	敬	德輿
張鋼	張	鋼	廷節
徐楷	徐	楷	宗範
王鉞	王	鉞	懋揚
戴乾	戴	乾	元之
王憲	王	憲	維綱
趙維藩	趙	維藩	价夫
陶煦	陶	煦	時和
彭惟方	彭	惟方	重義
趙士元	趙	士元	君聘
周澤	周	澤	天雨
吳玭	吳	玭	子懷
唐夔	唐	夔	宗韶
路麟	路	麟	肇治
黎民牧	黎	民牧	本恕
周冕	周	冕	尚文
郭濬	郭	濬	舜德
蕭巨源	蕭	巨源	用溥
徐欽	徐	欽	敬之
宋珫	宋	珫	廷璧
常元慶	常	元慶	宗善
董辰	董	辰	嗣紳
蕭淵	蕭	淵	文靜
王哲	王	哲	思德
羅賢	羅	賢	大用
陳威	陳	威	民望
陳大經	陳	大經	正之
周偉	周	偉	士元
于庭春	于	庭春	元之
陳文輔	陳	文輔	以道
常濟	常	濟	惠夫
李瓚	李	瓚	重器
陳謨	陳	謨	汝嘉
張瀚	張	瀚	克容
周爵	周	爵	天爵
席書	席	書	文同
陳祿	陳	祿	天錫
劉文寵	劉	文寵	元錫
劉棠	劉	棠	思召
胡雍	胡	雍	伯雍
郭綸	郭	綸	大綸
盧翊	盧	翊	鳳翀
高崇熙	高	崇熙	文明
葉永秀	葉	永秀	汝實
張鼒	張	鼒	宗獻
杜楷	杜	楷	公式
賈璇	賈	璇	天器
顏頤壽	顏	頤壽	天和
姜實	姜	實	若虛
呂鏜	呂	鏜	廷韶
茅光著	茅	光著	日升
余敬	余	敬	行簡
饒榶	饒	榶	文中
蒙惠	蒙	惠	允濟
謝璽	謝	璽	宗玉
杜宏	杜	宏	淵之
孫傑	孫	傑	朝用
范璋	范	璋	邦獻
吳瓚	吳	瓚	美中
陸徵	陸	徵	時休
臧鳳	臧	鳳	瑞周
張表	張	表	人傑
胡希顏	胡	希顏	宗哲
鄧文質	鄧	文質	汝中
王丞巴	王	丞巴	汝器
石存禮	石	存禮	敬夫
左然	左	然	允之
陳曦	陳	曦	景和
林廷瓛	林	廷瓛	公器
萬璇	萬	璇	廷器
伍希齊	伍	希齊	孟倫
楊滋	楊	滋	天澤
劉綱	劉	綱	克立
何勝	何	勝	斯復
李聰	李	聰	敏德
孫璉	孫	璉	宗器
秦銳	秦	銳	克進
陳熙	陳	熙	士勛
景佐	景	佐	良弼
楊璋	楊	璋	廷宜
余止	余	止	景山
陳玉	陳	玉	德輝
彭鳳來	彭	鳳來	泰和
鄭瓘	鄭	瓘	溫卿
許慶	許	慶	應禎
王瓚	王	瓚	宗用
汪金恩	汪	金恩	天錫
黃聚	黃	聚	朝會
左璋	左	璋	廷貴
徐鈺	徐	鈺	用礪
李傑	李	傑	人英
公勉仁	公	勉仁	尚德
李師儒	李	師儒	宗正
王鼎	王	鼎	重器
張輝	張	輝	蘊之
夏昇	夏	昇	景熙
何洽	何	洽	允仁
陳輔	陳	輔	汝德
高友璣	高	友璣	肅政
楊鐸	楊	鐸	朝魯
張金	張	金	質夫
劉溥	劉	溥	公濟
劉瑜	劉	瑜	美之
房瑄	房	瑄	廷獻
陳澍	陳	澍	天澤
李敷	李	敷	春敷
丘俊	丘	俊	邦彥
陸廣	陸	廣	士弘
翟敬	翟	敬	行簡
劉芳	劉	芳	德馨
徐浤	徐	浤	本深
楊璲	楊	璲	廷珮
譚溥	譚	溥	德周
呂賢	呂	賢	邦佑
劉愷	劉	愷	承華
陶照	陶	照	時明
張鸞	張	鸞	應治
賈瓘	賈	瓘	伯玉
王序	王	序	天秩
毛澄	毛	澄	憲清
徐穆	徐	穆	舜和
羅欽順	羅	欽順	允升
顧清	顧	清	士廉
謝朝宣	謝	朝宣	汝為
陳嬰	陳	嬰	民懷
鄭岳	鄭	岳	汝華
劉煥	劉	煥	堯章
宋愷	宋	愷	舜臣
方璘	方	璘	文玉
吳綡	吳	綡	時冕
陸相	陸	相	良弼
高江	高	江	一龍
汪獲麟	汪	獲麟	仁甫
趙永楨	趙	永楨	終吉
趙士賢	趙	士賢	孟希
蕭柯	蕭	柯	升榮
趙松	趙	松	天挺
沈燾	沈	燾	良德
李夢陽	李	夢陽	天賜
張文	張	文	經載
曹瓊	曹	瓊	玉夫
錢啟宏	錢	啟宏	以仁
馮蘭	馮	蘭	子佩
何孟春	何	孟春	子元
王承裕	王	承裕	天宇
尚繻	尚	繻	美信
周季鳳	周	季鳳	公儀
劉景寅	劉	景寅	生之
吳一鵬	吳	一鵬	南夫
張良弼	張	良弼	夢徵
邢珣	邢	珣	子用
白金	白	金	士珍
錢榮	錢	榮	世恩
秦金	秦	金	國聲
陳元	陳	元	虞佐
鄒文盛	鄒	文盛	時鳴
李麟	李	麟	仁仲
夏從壽	夏	從壽	如山
徐廷用	徐	廷用	良佐
高濟	高	濟	楫之
楊昇	楊	昇	起同
李寬	李	寬	敬敷
曹鏷	曹	鏷	良金
汪俊	汪	俊	抑之
杭濟	杭	濟	世卿
何珊	何	珊	廷佩
徐守誠	徐	守誠	成之
鍾渤	鍾	渤	元溥
鄭允宣	鄭	允宣	嘉言
徐沂	徐	沂	希曾
郝海	郝	海	汝容
孔琦	孔	琦	景韓
范祺	范	祺	應禎
劉昭	劉	昭	仲賢
劉介	劉	介	師惠
張綽	張	綽	本寬
張宦	張	宦	惟臣
羅中	羅	中	道原
冒鸞	冒	鸞	廷和
陳策	陳	策	嘉言
陳時憲	陳	時憲	孔章
吳英	吳	英	世傑
陶廷威	陶	廷威	以重
王大用	王	大用	世顯
黃明	黃	明	天章
婁宿	婁	宿	拱辰
曾鎰	曾	鎰	時重
夏易	夏	易	連山
潘子秀	潘	子秀	人傑
梁辰	梁	辰	應樞
胡澧	胡	澧	百鍾
馬馭	馬	馭	世維
林亨	林	亨	貞甫
曾介	曾	介	執初
董俊	董	俊	虞臣
楊壽	楊	壽	德邵
楊泮	楊	泮	文淵
姚鏌	姚	鏌	英之
黃銘	黃	銘	于鼎
王舜夫	王	舜夫	從仁
徐蕃	徐	蕃	宣之
劉弼	劉	弼	直之
周玉	周	玉	朝振
陸偁	陸	偁	君美
王恂	王	恂	師誠
盧儀	盧	儀	正夫
王翀	王	翀	廷鳳
黃澤　	黃	澤　	若雨
褚圻	褚	圻	弘望
周魯	周	魯	醇夫
黃瀾	黃	瀾	源續
周憲	周	憲	時敏
陳璘	陳	璘	邦瑞
王純	王	純	希文
曹廉	曹	廉	惟清
楊二和	楊	二和	恭甫
陳諫	陳	諫	汝弼
李實	李	實	若虛
于瑁	于	瑁	朝瑞
王應奎	王	應奎	文瑞
李元	李	元	德元
杜旻	杜	旻	德仁
余濂	余	濂	宗周
夏璲	夏	璲	廷贊
趙繼爵	趙	繼爵	世忠
姜閎	姜	閎	道淵
彭縉	彭	縉	文卿
徐翊	徐	翊	中行
馬陟	馬	陟	文明
胡爟	胡	爟	仲光
常賜	常	賜	承恩
東思恭	東	思恭	進賢
鄺璠	鄺	璠	廷瑞
馮清	馮	清	汝揚
盧瀚	盧	瀚	文淵
王縝	王	縝	文哲
徐瑤	徐	瑤	粹卿
鄭端	鄭	端	司直
何歆	何	歆	子敬
胡世寧	胡	世寧	永清
徐瀾	徐	瀾	文淵
辛文淵	辛	文淵	道深
鄭錫文	鄭	錫文	禹範
吳鵬	吳	鵬	孔騰
張環	張	環	瑤夫
高達	高	達	上達
劉瑜	劉	瑜	廷璧
陳繗	陳	繗	克紹
院賓	院	賓	君聘
李允	李	允	信之
李鏊	李	鏊	時濟
張顯	張	顯	晦夫
雷顒	雷	顒	敬之
武皐	武	皐	舜弼
龐璁	龐	璁	潤夫
楊公榮	楊	公榮	仲仁
夏時	夏	時	寅正
程忠顯	程	忠顯	良輔
范希淹	范	希淹	景賢
王選	王	選	慎簡
范鏞	范	鏞	鳴遠
侯溪	侯	溪	守止
王時	王	時	時中
蔚春	蔚	春	景元
劉演	劉	演	文敷
劉蘭	劉	蘭	廷馥
郭瑀	郭	瑀	佩之
史載德	史	載德	公著
胡瓚	胡	瓚	伯珩
宋愷	宋	愷	良佐
楊遜	楊	遜	宗讓
任良弼	任	良弼	廷贊
方矩	方	矩	大器
王綬	王	綬	朝儀
李情	李	情	宗善
李舉	李	舉	大聘
盛應期	盛	應期	斯徵
田佑	田	佑	廷相
杜馴	杜	馴	克善
曹瓊	曹	瓊	廷玉
高謙	高	謙	天益
王紹	王	紹	繼宗
仰儒	仰	儒	世用
吳舜	吳	舜	子華
楊儀	楊	儀	宗德
鄭宣	鄭	宣	士達
裘壤	裘	壤	本厚
王慶	王	慶	天德
王廷	王	廷	惟極
柯拱北	柯	拱北	斗南
林璋	林	璋	用玉
王雄	王	雄	世傑
王弘	王	弘	叔毅
熊希谷	熊	希谷	尚友
翁茂南	翁	茂南	朝梁
馮經	馮	經	時濟
李承勛	李	承勛	立卿
劉廷策	劉	廷策	以楊
李璣	李	璣	舜在
劉武臣	劉	武臣	希召
王子成	王	子成	公大
郭浹	郭	浹	從仁
孫徽	孫	徽	德夫
劉賢	劉	賢	世資
林坌	林	坌	世集
王昊	王	昊	汝欽
鍾文俊	鍾	文俊	舜臣
李雍	李	雍	欽讓
韓大章	韓	大章	本中
徐淮	徐	淮	必東
胡濂	胡	濂	宗周
王獻臣	王	獻臣	敬止
李儀	李	儀	公著
韓紘	韓	紘	繼遠
高遷	高	遷	大用
許天錫	許	天錫	啟衷
吳天祐	吳	天祐	吉甫
高選	高	選	朝用
奚自	奚	自	從之
李夢龍	李	夢龍	應靈
楊簡	楊	簡	居敬
閭潔	閭	潔	汝清
胡鰲	胡	鰲	鎮之
周昶	周	昶	啟明
許莊	許	莊	德徵
吳雲	吳	雲	從龍
龍越	龍	越	德宣
胡暘	胡	暘	景和
薛格	薛	格	平甫
施震	施	震	亨甫
李瑾	李	瑾	德美
曾大有	曾	大有	世亨
王德	王	德	汝昭
潘輔	潘	輔	良佐
陳玉	陳	玉	德卿
李欽	李	欽	元肅
鄭興	鄭	興	世隆
侯啟忠	侯	啟忠	汝弼
楊奎	楊	奎	天章
潘衍	潘	衍	世昌
陳陽	陳	陽	健夫
董銳	董	銳	抑之
冉繼志	冉	繼志	孝隆
李金	李	金	宗乾
李天賦	李	天賦	凝道
胡昉	胡	昉	啟暘
顧守元	顧	守元	明善
黃鑅	黃	鑅	于宣
王良臣	王	良臣	汝隣
曹恕	曹	恕	本忠
黎堯卿	黎	堯卿	廷表
姚昊	姚	昊	文大
劉璉	劉	璉	廷美
黃信	黃	信	君實
王崇文	王	崇文	叔武
胡恩	胡	恩	允承
董䋊	董	䋊	嗣文
譚玉瑞	譚	玉瑞	雅祥
馬慶	馬	慶	善徵
蘇信	蘇	信	中孚
李希顏	李	希顏	原復
江師古	江	師古	克永
陳熺	陳	熺	師晦
桂詔	桂	詔	世欽
朱瑬	朱	瑬	孔貴
王縉	王	縉	維卿
尹雄	尹	雄	文英
鮑王輦	鮑	王輦	重器
何垕	何	垕	朝舉
秦文	秦	文	從簡
焦澤	焦	澤	克濟
房瀛	房	瀛	登之
陳霖	陳	霖	時雨
張瓊	張	瓊	國用
鄭汝美	鄭	汝美	希大
趙俊	趙	俊	克用
劉汝靖	劉	汝靖	安之
李嶽	李	嶽	維嵩
姚鼎	姚	鼎	重器
歐陽介	歐陽	介	勗辨
李濬	李	濬	文淵
袁仕	袁	仕	良輔
居達	居	達	德亨
陳珀	陳	珀	珍之
任文獻	任	文獻	國光
湯佐	湯	佐	時衡
李祚	李	祚	光世
孫瑞	孫	瑞	季禎
廖漢	廖	漢	天章
徐永	徐	永	昌齡
姚學禮	姚	學禮	以立
劉袤	劉	袤	廷延
曹璽	曹	璽	廷玉
張彧	張	彧	文翰
黃清	黃	清	源潔
鄭懷德	鄭	懷德	端本
楊志學	楊	志學	遜夫
呂佑	呂	佑	國弼
孫燧	孫	燧	德成
高文達	高	文達	思德
程杲	程	杲	時昭
吳煥	吳	煥	文明
王用才	王	用才	經濟
石確	石	確	德堅
高臺	高	臺	居賢
徐潭	徐	潭	汝容
惠隆	惠	隆	從道
黃清	黃	清	汝寅
李哲	李	哲	希先
田嵓	田	嵓	景瞻
陳腆	陳	腆	洪載
劉浙	劉	浙	宗岱
鄒韶	鄒	韶	性之
王汝清	王	汝清	廉甫
李世亨	李	世亨	雍行
王震	王	震	威遠
張斆	張	斆	時學
朱希周	朱	希周	懋忠
王瓚	王	瓚	思獻
陳瀾	陳	瀾	本初
李永敷	李	永敷	貽教
李瓚	李	瓚	宗器
顧潛	顧	潛	孔昭
陳鳳梧	陳	鳳梧	文鳴
史後	史	後	巽仲
濮韶	濮	韶	和仲
陳諮	陳	諮	汝謀
左唐	左	唐	堯卿
蔡栻	蔡	栻	元敬
陸冒	陸	冒	尚德
胡獻	胡	獻	時臣
張潛	張	潛	用昭
鄒軒	鄒	軒	公輊
董天錫	董	天錫	壽甫
張玠	張	玠	世奇
王藎	王	藎	惟忠
翁玉	翁	玉	潤之
王朝卿	王	朝卿	升之
皇甫錄	皇甫	錄	世庸
周曾	周	曾	希沂
沈綸	沈	綸	朝綬
董忱	董	忱	世行
王宣	王	宣	承德
周臣	周	臣	元弼
趙鶴	趙	鶴	叔鳴
劉東	劉	東	元昭
黃相	黃	相	弼甫
簡芳	簡	芳	德馨
張諾	張	諾	承之
甘振	甘	振	大聲
陳言	陳	言	子朝
張秀	張	秀	成實
嚴經	嚴	經	□
吳大有	吳	大有	元亨
李嘉祥	李	嘉祥	時鳳
張紹齡	張	紹齡	壽卿
吳江	吳	江	從岷
劉光	劉	光	景晦
高節	高	節	介夫
劉喬	劉	喬	世臣
艾洪	艾	洪	德裕
汝泰	汝	泰	□通
熊偉	熊	偉	彥卿
鮑璋	鮑	璋	德卿
劉祥	劉	祥	□慶
程琯	程	琯	德和
王朝佐	王	朝佐	廷望
何詔	何	詔	廷綸
周鼎	周	鼎	定之
胡鍵	胡	鍵	希準
孫祿	孫	祿	天錫
龍霓	龍	霓	致仁
曹琚	曹	琚	仲玉
華㫤	華	㫤	文光
謝傑	謝	傑	循卿
李珪	李	珪	用獻
胡璽	胡	璽	伯章
尚衡	尚	衡	一中
呂元夫	呂	元夫	仲仁
劉用中	劉	用中	道行
董恬	董	恬	世良
宋毓	宋	毓	鍾秀
張邦瑞	張	邦瑞	天鳳
陳霽	陳	霽	子宇
劉思賢	劉	思賢	用賓
戴敏	戴	敏	遜之
汪璧	汪	璧	叔完
包澤	包	澤	民望
謝麒	謝	麒	應祥
楊褫	楊	褫	介福
葉德	葉	德	宗本
耿明	耿	明	晦之
黃昭	黃	昭	明甫
沈文華	沈	文華	崇實
李誠	李	誠	則明
鄧洹	鄧	洹	宇清
張鳳羾	張	鳳羾	來儀
李源	李	源	宗一
王子言	王	子言	如行
羅璋	羅	璋	瑞卿
陳言	陳	言	汝昌
王壽	王	壽	希仁
蔡中孚	蔡	中孚	信之
韓俊	韓	俊	克章
李鉞	李	鉞	處甫
陳洪謨	陳	洪謨	宗禹
孟春	孟	春	時元
彭夔	彭	夔	師舜
楊學禮	楊	學禮	立夫
黃衷	黃	衷	子和
戴達	戴	達	景伊
李達	李	達	士行
季春	季	春	體仁
賈詠	賈	詠	鳴和
何俊	何	俊	邦彥
汪偉	汪	偉	器之
傅習	傅	習	本學
徐聯	徐	聯	成章
田瑛	田	瑛	玉汝
胡洪	胡	洪	淵之
黎鳳	黎	鳳	乾兆
莊典	莊	典	惇之
許承芳	許	承芳	世美
郭郛	郭	郛	于蕃
葉天爵	葉	天爵	良貴
王鍭	王	鍭	子鋒
張偉	張	偉	汝賢
張鳴鳳	張	鳴鳳	子喈
邵坤	邵	坤	文博
余正	余	正	端卿
何天衢	何	天衢	道亨
劉台	劉	台	衛仲
王孝忠	王	孝忠	全之
金逵	金	逵	□
李璽	李	璽	朝信
邵有道	邵	有道	虞臣
湯沐	湯	沐	新之
歐陽瓊	歐陽	瓊	汝玉
林珹	林	珹	時獻
趙士俊	趙	士俊	孟章
郭東山	郭	東山	魯瞻
汪循	汪	循	進之
陳茂烈	陳	茂烈	時周
王崇獻	王	崇獻	季徵
楊溢	楊	溢	宗謙
張鳴鳳	張	鳴鳳	世祥
蕭敏	蕭	敏	淳仁
王春	王	春	景陽
費愚	費	愚	希明
弓元	弓	元	大方
王九思	王	九思	敬夫
邢昭	邢	昭	孟明
徐朝元	徐	朝元	一敬
徐行慶	徐	行慶	思道
范兆祥	范	兆祥	廷和
蔣曙	蔣	曙	景明
張璡	張	璡	伯純
劉欒	劉	欒	思武
沈信	沈	信	循初
周霖	周	霖	希說
胡道	胡	道	濟時
楊武	楊	武	宗文
姚文淵	姚	文淵	宗翰
喻時	喻	時	子乾
陸嵩	陸	嵩	如嵩
張惟	張	惟	云謨
傅乾	傅	乾	一清
宋瑭	宋	瑭	德潤
李高	李	高	自早
張弘至	張	弘至	時行
楊鳳	楊	鳳	文明
徐忱	徐	忱	□心
方崙	方	崙	靜夫
熊吉	熊	吉	伯修
張羽	張	羽	鳳舉
何正	何	正	立經
冠儉	冠	儉	約之
陳大紀	陳	大紀	勉之
翟銓	翟	銓	秉衡
吳宗周	吳	宗周	子旦
湯禮敬	湯	禮敬	仁甫
薄彥徽	薄	彥徽	舜美
孫磐	孫	磐	伯堅
陳淮	陳	淮	秀南
鄒魯	鄒	魯	尚儒
崔璽	崔	璽	廷用
李熙	李	熙	師文
黃瓛	黃	瓛	朝用
吳景	吳	景	伯陽
文晧	文	晧	孔晹
許讚	許	讚	廷美
葛浩	葛	浩	天宏
馮永固	馮	永固	□□
趙慰	趙	慰	本安
周道	周	道	嘉猷
陳琳	陳	琳	玉疇
張繹	張	繹	思紹
周熊	周	熊	應文
林正茂	林	正茂	孔時
孫焵	孫	焵	礪之
李翔	李	翔	鳳儀
袁陽	袁	陽	健甫
劉汝為	劉	汝為	廷宣
黃圻	黃	圻	朝寰
徐海	徐	海	伯容
張禮	張	禮	天秩
陸崑	陸	崑	如崑
張時敘	張	時敘	九敘
錢朝鳳	錢	朝鳳	□□
安仁	安	仁	存德
安奎	安	奎	應文
沈賚	沈	賚	功懋
崔暠	崔	暠	景曜
楊譽	楊	譽	中美
夏鼎	夏	鼎	汝梅
朱諫	朱	諫	君佐
馬應祥	馬	應祥	公□
詹寶	詹	寶	天球
李恕	李	恕	道夫
王禾	王	禾	世用
秦昂	秦	昂	民望
貢安甫	貢	安甫	克仁
潘鏜	潘	鏜	宗節
曹來旬	曹	來旬	伯良
戴銑	戴	銑	寶之
余琰	余	琰	公瑞
王璽	王	璽	仲信
冼光	冼	光	汝寶
馬文盛	馬	文盛	郁卿
馬龍	馬	龍	虞臣
馬騤	馬	騤	世用
王士昭	王	士昭	希賢
蔣欽	蔣	欽	子修
劉珂	劉	珂	公佩
平世用	平	世用	德充
程材	程	材	良用
韓澤	韓	澤	孔仁
趙經	趙	經	天常
吳遠	吳	遠	惟明
鄒泰	鄒	泰	以和
周季邦	周	季邦	公□
田登	田	登	有年
荀鳳	荀	鳳	文瑞
陳天祥	陳	天祥	元吉
徐璁	徐	璁	朝器
沈恩	沈	恩	仁甫
羅鳳	羅	鳳	子文
鄧萬斛	鄧	萬斛	汝庸
姜文魁	姜	文魁	士元
楊瑋	楊	瑋	伯玉
鄭陽	鄭	陽	宗乾
王渙	王	渙	時霖
曹閔	曹	閔	宗孝
杜玧	杜	玧	仲純
劉玉	劉	玉	咸栗
趙廉	趙	廉	一清
楊溥	楊	溥	靜夫
閻宇	閻	宇	大啟
魏訥	魏	訥	尚默
丘泰	丘	泰	守嚴
徐淮	徐	淮	伯川
左輔	左	輔	弼之
郭經	郭	經	載道
馮顒	馮	顒	有□
熊卓	熊	卓	士選
唐錦	唐	錦	士綗
唐欽	唐	欽	元敬
徐昂	徐	昂	文舉
王琮	王	琮	玉振
顧璘	顧	璘	華玉
陳文試	陳	文試	道衡
姜佐	姜	佐	廷輔
郁勲	郁	勲	元績
薛𣁦	薛	𣁦	全卿
張拱	張	拱	文瑞
劉麟	劉	麟	元端
扈湘	扈	湘	孔般
范淵	范	淵	靜之
高賓	高	賓	舜穆
陶諧	陶	諧	世和
劉瑞	劉	瑞	德夫
聶瑄	聶	瑄	廷器
韓廉	韓	廉	守清
周璽	周	璽	天章
張昊	張	昊	朝元
甯杲	甯	杲	仲升
彭震	彭	震	子器
范璘	范	璘	敬溫
劉溥	劉	溥	潤民
王尚賓	王	尚賓	朝重
金麒壽	金	麒壽	仁甫
莊𥜃	莊	𥜃	誠之
戴冕	戴	冕	從周
程乾	程	乾	德易
儲秀	儲	秀	子竟
唐榮	唐	榮	仁夫
鄭思紀	鄭	思紀	宗禮
陳順	陳	順	裕夫
張芝	張	芝	庭毓
鄒賢	鄒	賢	恢才
邊貢	邊	貢	庭實
任惠	任	惠	濟民
李廷光	李	廷光	德華
秦誠通	秦	誠通	孟陽
劉烈	劉	烈	祥炳
耿繼玄	耿	繼玄	顯之
李天衢	李	天衢	行之
王綸	王	綸	演之
許蕃	許	蕃	邦憲
劉繹	劉	繹	以成
白杲	白	杲	光宇
嚴泰	嚴	泰	時和
曹琛	曹	琛	廷實
余洙	余	洙	宗魯
童品	童	品	廷式
康海	康	海	德涵
孫清	孫	清	直卿
李廷相	李	廷相	夢弼
胡煜	胡	煜	廷和
魯鐸	魯	鐸	振之
薛金	薛	金	子純
蘇乾	蘇	乾	體健
李璋	李	璋	德方
王尚絅	王	尚絅	錦夫
楊節	楊	節	本中
曹崐	曹	崐	來鳳
林魁	林	魁	廷元
溫仁和	溫	仁和	民懷
李時	李	時	宗易
季斆	季	斆	彥文
汪舉	汪	舉	用之
滕霄	滕	霄	子沖
汪獻	汪	獻	維賢
徐天澤	徐	天澤	惠民
儲南	儲	南	光遠
方天雨	方	天雨	濟甫
呂夔	呂	夔	祖邦
吉時	吉	時	惟可
劉吉	劉	吉	循理
朱袞	朱	袞	朝章
董灌	董	灌	存誠
歐陽誥	歐陽	誥	賜之
章寓之	章	寓之	道充
胡軒	胡	軒	士榮
李津	李	津	濟之
趙永	趙	永	爾錫
馮志	馮	志	行甫
楊一鈞	楊	一鈞	秉衡
施訓	施	訓	庭方
蘇時秀	蘇	時秀	汝實
徐	徐		允升
劉悅	劉	悅	以貞
梁錦	梁	錦	美中
徐麟	徐	麟	仁伯
李貫	李	貫	志道
陸健	陸	健	文順
韓士奇	韓	士奇	秀夫
黃閱古	黃	閱古	時準
唐冑	唐	冑	平侯
畢濟川	畢	濟川	汝舟
歐陽恂	歐陽	恂	誠之
沈應經	沈	應經	德徵
王昹	王	昹	景昭
王濟	王	濟	體民
王納誨	王	納誨	獻可
何瑭	何	瑭	粹夫
談倫	談	倫	敬仲
戴敔	戴	敔	廷韶
毛思義	毛	思義	繼賢
謝廷瑞	謝	廷瑞	邦應
歐陽祿	歐陽	祿	萬鍾
程雲鵬	程	雲鵬	汝南
王金	王	金	曰良
馬文	馬	文	質夫
惲巍	惲	巍	功甫
汪鋐	汪	鋐	宣之
盛鍾	盛	鍾	秀甫
葉鳳靈	葉	鳳靈	昌韶
葉釗	葉	釗	時勉
汪彬	汪	彬	學之
劉天麒	劉	天麒	仁徵
王顯道	王	顯道	微之
鍾文傑	鍾	文傑	邦臣
王宗	王	宗	惟本
張秉清	張	秉清	元量
林烶	林	烶	廷光
廖俊	廖	俊	德章
鄭信	鄭	信	德孚
楊瑋	楊	瑋	景奇
徐暹	徐	暹	進甫
周舉	周	舉	尚賓
趙祜	趙	祜	汝承
楊欽	楊	欽	敬之
梁喬	梁	喬	遷之
張鉞	張	鉞	朝肅
黃巽	黃	巽	啟亨
張騰霄	張	騰霄	鳳騫
張瀾	張	瀾	道夫
黃體行	黃	體行	于道
楊果	楊	果	實夫
唐懽	唐	懽	季和
許元奎	許	元奎	文華
呂浩	呂	浩	文瀚
盧學書	盧	學書	用中
陳九疇	陳	九疇	禹學
王雲	王	雲	天章
陳炫	陳	炫	文光
祁敏	祁	敏	惟學
丁沂	丁	沂	宗魯
宋冕	宋	冕	孔瞻
殷鏊	殷	鏊	文濟
張禬	張	禬	汝吉
吳便	吳	便	廷言
卞思敏	卞	思敏	行甫
項匡	項	匡	直卿
康紀	康	紀	在脩
蔡銓	蔡	銓	選之
吳鉞	吳	鉞	宿威
張龍	張	龍	汝言
林茂達	林	茂達	孚可
宇文鍾	宇文	鍾	伯秀
陳察	陳	察	原習
陸鰲	陸	鰲	鎮卿
尹綸	尹	綸	大經
段豸	段	豸	世高
何義	何	義	時宜
劉琛	劉	琛	廷獻
魯鐸	魯	鐸	文振
李元吉	李	元吉	守正
童鉞	童	鉞	秉虔
霍恩	霍	恩	天錫
劉弼	劉	弼	邦直
周禎	周	禎	天兆
虞夔	虞	夔	汝諧
馮憲	馮	憲	遵古
劉經	劉	經	貞甫
成文	成	文	質夫
武思明	武	思明	克誠
白思誠	白	思誠	實之
鄭選	鄭	選	于眾
陳祥	陳	祥	應和
方進	方	進	以禮
沈欽	沈	欽	敬之
王廷相	王	廷相	秉衡
危行	危	行	世隆
李學曾	李	學曾	宗魯
姚鵬	姚	鵬	鳴南
江淙	江	淙	朝會
張雲	張	雲	季升
訾綬	訾	綬	文甫
徐問	徐	問	用中
王材	王	材	天成
羅縉	羅	縉	薦卿
上官崇	上官	崇	達卿
石邦柱	石	邦柱	安國
何士麟	何	士麟	肇周
姜榮	姜	榮	仁甫
鄭濬	鄭	濬	克明
黃河清	黃	河清	應期
曹勑	曹	勑	嘉正
張元春	張	元春	幼仁
顧燁	顧	燁	耀卿
洪範	洪	範	邦正
蔣瓊	蔣	瓊	尚德
曹岐	曹	岐	鳴鳳
王注	王	注	禹成
張廷槐	張	廷槐	文相
梅珂	梅	珂	邦振
祝濬	祝	濬	仲源
劉布	劉	布	時服
錢如京	錢	如京	公溥
董鑄	董	鑄	克成
張潤	張	潤	汝霖
朱絃	朱	絃	廷和
范嵩	范	嵩	邦秀
曾直	曾	直	叔溫
朱儼	朱	儼	居正
王鍇	王	鍇	叔金
鄺約	鄺	約	文博
鍾紹	鍾	紹	大韶
高壇	高	壇	用明
陳璣	陳	璣	天儀
楊恭	楊	恭	秉虔
劉諶	劉	諶	承芳
仇惠	仇	惠	澤民
劉儒	劉	儒	寄道
何淳	何	淳	宗厚
熊紀	熊	紀	時振
舒晟	舒	晟	孔暘
張柱	張	柱	汝賢
王俸	王	俸	天爵
張萱	張	萱	德暉
潘珍	潘	珍	玉卿
嚴紘	嚴	紘	仲周
戴書	戴	書	天錫
黃宏	黃	宏	德裕
賀洪	賀	洪	禹疇
藍郁	藍	郁	國馨
吳祺	吳	祺	貴德
張諧	張	諧	汝諧
安佑	安	佑	于吉
原軒	原	軒	公載
何亮	何	亮	文明
李鑑	李	鑑	孔昭
潘希曾	潘	希曾	仲魯
何棐	何	棐	輔之
孫沔	孫	沔	伯清
陳霆	陳	霆	聲伯
侯自明	侯	自明	景德
凌雲翰	凌	雲翰	伯遠
朱嘉會	朱	嘉會	亨之
陳寧	陳	寧	仕泰
吳儀	吳	儀	德隅
丘世喬	丘	世喬	民望
鄧翰	鄧	翰	希召
李淳	李	淳	原朴
何渥	何	渥	承恩
盛端明	盛	端明	希道
張岐	張	岐	宗周
萬斛	萬	斛	以虛
吳閱	吳	閱	廷簡
張賢	張	賢	守愚
何紹正	何	紹正	繼宗
雷宗	雷	宗	希曾
區玉	區	玉	廷璋
王鉉	王	鉉	伯舉
俞泰	俞	泰	國昌
張天錫	張	天錫	惟範
吳允禎	吳	允禎	天祐
田中	田	中	立夫
東野	東	野	希孟
查約	查	約	原博
顧英	顧	英	順中
陸節	陸	節	享甫
李春芳	李	春芳	資元
李伸	李	伸	道甫
章拯	章	拯	以道
葉信	葉	信	中孚
陳璧	陳	璧	德如
于聰	于	聰	士達
萬英	萬	英	子俊
許瀚	許	瀚	彥卿
徐珙	徐	珙	庭實
吾翯	吾	翯	廷介
胡訓	胡	訓	誨之
喬岱	喬	岱	希申
胡節	胡	節	國信
郗夔	郗	夔	舜臣
胡鎮	胡	鎮	斯靖
田紱	田	紱	大章
姚隆	姚	隆	原學
陳鼐	陳	鼐	汝和
李奎昭	李	奎昭	文振
張嘉謨	張	嘉謨	舜卿
朱昴	朱	昴	文宿
王爌	王	爌	存約
徐元稔	徐	元稔	明嘉
陳猷	陳	猷	汝嘉
張芹	張	芹	文林
甯溥	甯	溥	公父
卞諶	卞	諶	信卿
謝表	謝	表	正邦
周鑰	周	鑰	希準
葉相	葉	相	良臣
蕭杲	蕭	杲	彥明
葉良	葉	良	漢傑
周用	周	用	行之
薛价	薛	价	藩卿
高嶼	高	嶼	子洲
李錫	李	錫	天爵
陳義	陳	義	宜之
金賢	金	賢	士希
孫偉	孫	偉	朝望
屈銓	屈	銓	秉衡
塗文祥	塗	文祥	舜徵
李深	李	深	淵之
盧英	盧	英	文華
姚欽	姚	欽	敬夫
盧綸	盧	綸	朝言
喻文璧	喻	文璧	德卿
朱袞	朱	袞	子文
洪聰	洪	聰	謀甫
王萱	王	萱	時芳
許鳳	許	鳳	天祥
王奎	王	奎	文明
何景明	何	景明	仲默
顧正	顧	正	尚誠
張雲鵬	張	雲鵬	天翼
李際可	李	際可	公遇
鄭裕	鄭	裕	有容
林塾	林	塾	從學
蘇仲	蘇	仲	亞夫
陳實	陳	實	秀卿
鍾湘	鍾	湘	□□
何沾	何	沾	宗澤
劉時望	劉	時望	傅霖
劉安	劉	安	以靜
張顒	張	顒	子孚
師夔	師	夔	汝和
曾大顯	曾	大顯	世榮
張璉	張	璉	汝器
符樂	符	樂	同和
郁侃	郁	侃	希正
涂敬	涂	敬	寅之
李鐸	李	鐸	孔教
沈炤	沈	炤	文明
吳玉榮	吳	玉榮	貴卿
王鑾	王	鑾	拱之
林富	林	富	守仁
孫昂	孫	昂	廷舉
李陽春	李	陽春	宗元
陸經	陸	經	載道
顧鼎成	顧	鼎成	九和
董玘	董	玘	文玉
謝丕	謝	丕	以中
崔銑	崔	銑	仲鳬
嚴嵩	嚴	嵩	維中
湛若水	湛	若水	元明
王秉良	王	秉良	伯存
朱琉	朱	琉	德嘉
倪宗正	倪	宗正	本端
胡璉	胡	璉	重器
陸深	陸	深	子淵
魏校	魏	校	□□
翟鑾	翟	鑾	□□
王綖	王	綖	邃伯
崔傑	崔	傑	世興
邵天和	邵	天和	□□
李汛	李	汛	□
宋景	宋	景	以賢
徐縉	徐	縉	子容
郭璋	郭	璋	□□
許諫	許	諫	□□
張鶠	張	鶠	九苞
秦偉	秦	偉	世觀
金轂	金	轂	弘□
張文麟	張	文麟	□
牛魯	牛	魯	道宗
李寅	李	寅	教之
張承仁	張	承仁	□
宋以方	宋	以方	
魏廷楫	魏	廷楫	廷涵
安金	安	金	汝礪
沈環	沈	環	□□
江珏	江	珏	□
沈暕	沈	暕	景明
寧河	寧	河	伯東
王進賢	王	進賢	較□
陳銑	陳	銑	□
柴義	柴	義	時中
孫修	孫	修	岡吉
陸芸	陸	芸	時遙
張九敘	張	九敘	禹功
陳策	陳	策	萬言
姚繼巖	姚	繼巖	元肖
詹源	詹	源	□
劉節	劉	節	□
潘旦	潘	旦	希周
王良翰 	王	良翰 	仲申
陳錫 	陳	錫 	□卿
張錦 	張	錦 	文□
曹琥 	曹	琥 	瑞卿
廖紀 	廖	紀 	惟修
聞淵 	聞	淵 	□
蔡潮	蔡	潮	日源
方學 	方	學 	日升
張繼孟 	張	繼孟 	子醇
周墨 	周	墨 	文御
劉鵬 	劉	鵬 	□
向文璽 	向	文璽 	國信
盛儀 	盛	儀 	德章
李志剛 	李	志剛 	近□
顧可學 	顧	可學 	□□
閔槐	閔	槐	公甫
孫泰	孫	泰	時寅
方位 	方	位 	惟立
李緋 	李	緋 	廷章
徐子熙 	徐	子熙 	世昭
張綬 	張	綬 	朝用
馮友端 	馮	友端 	德□
陳卿 	陳	卿 	汝忠
林文纘	林	文纘	德緒
林文迪	林	文迪	廷吉
張伯相 	張	伯相 	東銳
陳簧	陳	簧	鴻韶
鄭銘 	鄭	銘 	克新
胡東臯 	胡	東臯 	汝登
劉滂	劉	滂	伯雨
李源 	李	源 	士達
郭灌	郭	灌	達誠
蔡需 	蔡	需 	時用
諸絢 	諸	絢 	用海
熊遇 	熊	遇 	道夫
向一陽 	向	一陽 	汝葵
王忠	王	忠	顯之
安邦 	安	邦 	彥臣
余洪恩	余	洪恩	子承
舒表 	舒	表 	民望
楊豳 	楊	豳 	厚甫
詹奎 	詹	奎 	□
馬陳圖 	馬	陳圖 	□
袁擯 	袁	擯 	接之
張麒 	張	麒 	子仁
郭楫 	郭	楫 	□
張瓚	張	瓚	廷獻
謝訥	謝	訥	尚敏
陳定之 	陳	定之 	準卿
徐禎卿 	徐	禎卿 	昌□
張簡 	張	簡 	□□
萬鏜	萬	鏜	□□
段炅 	段	炅 	□□
王良佐	王	良佐	□□
田瀾	田	瀾	汝觀
周明弼 	周	明弼 	夢良
蔡天祜	蔡	天祜	成之
黃質	黃	質	文之
劉澄亮	劉	澄亮	彥明
江文敏	江	文敏	克學
區越	區	越	□□
王儼	王	儼	世□
陳墀	陳	墀	德階
鄭行 	鄭	行 	世濟
胡鐸 	胡	鐸 	□□
葉溥 	葉	溥 	□用
劉恆 	劉	恆 	以貞
王鏜 	王	鏜 	彥聲
陳達 	陳	達 	□□
黃著	黃	著	□□
胡遠 	胡	遠 	子明
王堯封	王	堯封	伯圻
鄧鑾 	鄧	鑾 	鳴仲
易謨 	易	謨 	嘉言
劉藍 	劉	藍 	子青
朱錧 	朱	錧 	以獻
劉紘 	劉	紘 	景□
顧綸 	顧	綸 	朝章
鄭一初	鄭	一初	朝朔
吳華 	吳	華 	德輝
張叔安 	張	叔安 	岳卿
李珏	李	珏	廷重
王坊 	王	坊 	崇賢
馬思聰 	馬	思聰 	懋聞
高公韶 	高	公韶 	大和
曾瑀 	曾	瑀 	朝儀
邵廷璦	邵	廷璦	可愛
區行 	區	行 	中行
鮮冕 	鮮	冕 	文卿
黃瑗 	黃	瑗 	純玉
王一麟 	王	一麟 	明瑞
張鎔	張	鎔	從範
吳昂 	吳	昂 	德翼
孫樂	孫	樂	夔卿
林潮	林	潮	君信
董琦 	董	琦 	天粹
楊鏓 	楊	鏓 	充平
高淓 	高	淓 	潁之
馬卿 	馬	卿 	敬臣
劉寓生 	劉	寓生 	奇進
程文  	程	文  	煥章
郭濂	郭	濂	希周
陳言 	陳	言 	獻可
朱表 	朱	表 	民望
李茂元 	李	茂元 	本□
錢玹 	錢	玹 	□□
夏曆	夏	曆	國正
袁經 	袁	經 	載道
安磐 	安	磐 	□□
許完 	許	完 	綱之
王栻	王	栻	景張
穆孔暉	穆	孔暉	伯潛
謝瑞 	謝	瑞 	應麟
李堅 	李	堅 	魚夫
陳溥 	陳	溥 	一卿
陶驥 	陶	驥 	良伯
閻鐸	閻	鐸	道鳴
劉瓚 	劉	瓚 	朝重
王昂	王	昂	仲顒
李暘 	李	暘 	乂脩
滕遠  	滕	遠  	士毅
劉竑	劉	竑	伯慶
陳綱 	陳	綱 	正之
王敎	王	敎	証敷
蕭世賢	蕭	世賢	□□
黃鞏 	黃	鞏 	編固
雷啓東 	雷	啓東 	震之
王億 	王	億 	天與
張翰 	張	翰 	汝禎
馮時雍 	馮	時雍 	工□
張思齊	張	思齊	希賢
周廣	周	廣	充之
李艾 	李	艾 	子若
顧應祥 	顧	應祥 	□□
留志淑 	留	志淑 	克全
蘇明 	蘇	明 	視遠
王民質 	王	民質 	□實
王韋 	王	韋 	□
張璞 	張	璞 	中美
孫勝 	孫	勝 	敏中
李培齡 	李	培齡 	二□
劉舉	劉	舉	□
王希孟	王	希孟	宗哲
張羽 	張	羽 	伯翔
顧標 	顧	標 	□
張鵬 	張	鵬 	□
趙中道 	趙	中道 	從之
顧棠 	顧	棠 	良愛
黃如金 	黃	如金 	孝武
劉伯秀 	劉	伯秀 	□
余用 	余	用 	明卿
李淳	李	淳	德厚
毛玉 	毛	玉 	□成
陳璋 	陳	璋 	□
金瑜 	金	瑜 	□之
王子謨 	王	子謨 	如臯
胡沖霄	胡	沖霄	□□
閔楷 	閔	楷 	□
彭滋 	彭	滋 	益之
魏棨 	魏	棨 	喬儀
傅元 	傅	元 	□卿
陳鼎	陳	鼎	□
周宣 	周	宣 	彥通
謝國表 	謝	國表 	民瞻
張克溫 	張	克溫 	□
師臯 	師	臯 	□
殷雲霄 	殷	雲霄 	□夫
葉鵠 	葉	鵠 	時舉
馬文 	馬	文 	□
孫紹先 	孫	紹先 	汝□
劉守達 	劉	守達 	應徵
孫檠	孫	檠	明卿
楊鎡 	楊	鎡 	□
陳槐 	陳	槐 	□
胥文相 	胥	文相 	士衡
常在 	常	在 	守德
杜泰 	杜	泰 	□
樂頀 	樂	頀 	鳴殷
董建中 	董	建中 	商民
陳軾 	陳	軾 	子敬
張衍瑞 	張	衍瑞 	九承
李仕清	李	仕清	希獻
申綸 	申	綸 	廷言
郁浩 	郁	浩 	子淵
倪璋 	倪	璋 	獻□
陳九章	陳	九章	從一
周用 	周	用 	舜中
張經 	張	經 	天敘
石宗太	石	宗太	樂山
鄧文璧 	鄧	文璧 	□□
于範 	于	範 	覺甫
潘棠	潘	棠	希召
汪和 	汪	和 	惟節
胡汝楫 	胡	汝楫 	□
劉田 	劉	田 	伯耕
賀寬	賀	寬	懋教
吳盈	吳	盈	子持
丁儀	丁	儀	□□
索承學	索	承學	遜夫
蘇民	蘇	民	天秀
陳鉞	陳	鉞	德威
黃琮	黃	琮	元質
易舒誥	易	舒誥	欽之
馬馴 	馬	馴 	德夫
江良貴	江	良貴	汝思
周任 	周	任 	以仁
陳良翰 	陳	良翰 	景申
方獻科 	方	獻科 	叔賢
李玠 	李	玠 	朝信
程定	程	定	□美
陳進 	陳	進 	崇志
張翀	張	翀	鵬舉
毛棠 	毛	棠 	□□
馮應奎 	馮	應奎 	景祥
張士隆 	張	士隆 	仲脩
屠垚	屠	垚	文治
李時 	李	時 	□
張惠 	張	惠 	天澤
常道 	常	道 	文載
李楫 	李	楫 	濟之
孫孟舉 	孫	孟舉 	周之
陳琛	陳	琛	□
熊泰 	熊	泰 	元□
田汝耔 	田	汝耔 	勤甫
張寬 	張	寬 	□
劉孝 	劉	孝 	□
滕紀 	滕	紀 	子振
顧瑄 	顧	瑄 	玉卿
陶金	陶	金	□東
吳哲 	吳	哲 	子□
曹雷 	曹	雷 	啟東
潘選	潘	選	玉選
楊輔	楊	輔	介卿
鄭善夫 	鄭	善夫 	□
張邦奇 	張	邦奇 	常甫
曾念 	曾	念 	聖初
田登 	田	登 	有年
顧達 	顧	達 	□
陳淵	陳	淵	德深
戴德孺 	戴	德孺 	子良
張茂蘭 	張	茂蘭 	□
黃希英	黃	希英	如英
俞敬 	俞	敬 	一中
黃堂 	黃	堂 	允升
徐讚 	徐	讚 	朝儀
張仲賢	張	仲賢	尚□
師存智 	師	存智 	汝愚
徐慶亨 	徐	慶亨 	世嘉
王光佐 	王	光佐 	克藎
孟洋 	孟	洋 	□之
曹倣	曹	倣	汝學
劉宓	劉	宓	德義
王偉 	王	偉 	士元
徐盈 	徐	盈 	子謙
韓貴	韓	貴	道充
王瑤	王	瑤	佩之 
章嵩	章	嵩	士瞻
楊慎	楊	慎	用修
余本	余	本	子華
鄒守益	鄒	守益	謙之
許成名	許	成名	□仁
劉棟 	劉	棟 	元隆
馬應龍	馬	應龍	公濟
鄭玉	鄭	玉	于成
朱鳴陽	朱	鳴陽	應周
張璧	張	璧	崇象
應良	應	良	原忠
屠應塤	屠	應塤	文伯
徐明	徐	明	文陟
黃臣	黃	臣	伯鄰
尹襄	尹	襄	舜弼
劉朴	劉	朴	華甫
鄭元	鄭	元	伯生
黃鍾	黃	鍾	伯魁
董鏊	董	鏊	濟之
侯綸	侯	綸	廷言
張鵬程	張	鵬程	萬里
李重	李	重	元任
陳桓	陳	桓	德威
胡堯元	胡	堯元	廷獻
劉城	劉	城	維翰
汪玄錫 	汪	玄錫 	天啓
張𦐣	張	𦐣	震之
柴奇	柴	奇	德美
王世文	王	世文	質夫
湯繼文	湯	繼文	引之
李獻可	李	獻可	公從
吳寅	吳	寅	時正
許雲鵬	許	雲鵬	時亨
張孟中	張	孟中	道宗
金濂	金	濂	濬之
陳應武	陳	應武	光烈
蔣洽	蔣	洽	惟和
朱亮	朱	亮	廷相
梁億	梁	億	叔永
宋應奎	宋	應奎	文明
王元凱	王	元凱	堯卿
李文華	李	文華	惟順
張原明	張	原明	□復
畢濟時	畢	濟時	汝霖
任忠	任	忠	原孝
毛憲	毛	憲	式之
柴太	柴	太	德弘
王念	王	念	廷璽
韓明	韓	明	□
屠俓	屠	俓	貞卿
劉翀	劉	翀	士鳳
黎奭	黎	奭	師召
曹恩	曹	恩	汝錫
孫繼芳	孫	繼芳	世其
張鵬	張	鵬	搏南
管楫	管	楫	汝濟
戴吉	戴	吉	惟謙
汪惇	汪	惇	叔厚
徐咸 	徐	咸 	子正
余寬	余	寬	仲栗
許復禮	許	復禮	穉仁
楊守禮	楊	守禮	秉節
郭襓	郭	襓	堯章
戴恩	戴	恩	子充
胡璉	胡	璉	重美
黃景星	黃	景星	德瑞
牛鳳	牛	鳳	道徵
朱璠	朱	璠	廷輝
費寀	費	寀	子和
王道 	王	道 	純甫
杜杲	杜	杲	啓明
陸俸	陸	俸	□
張經 	張	經 	□
屠僑	屠	僑	□卿
盧雍	盧	雍	□
于湛	于	湛	瑩中
施儒	施	儒	聘之
張潮	張	潮	惟信
祝續	祝	續	遙緒
夏尙朴	夏	尙朴	敦夫
劉佐	劉	佐	以道
王鑾	王	鑾	汝和
裴繼芳 	裴	繼芳 	世賢
林有孚	林	有孚	以吉
姚爵	姚	爵	汝修
宋廷佐	宋	廷佐	良弼
郭清	郭	清	直夫
姜清	姜	清	源甫
沈健	沈	健	若乾
畢廷拱	畢	廷拱	敬夫
梁穀	梁	穀	仲用
張愈嚴 	張	愈嚴 	濟寬
王介	王	介	守之
王思	王	思	宜學
郭九臯 	郭	九臯 	鳴世
李楫	李	楫	大濟
何壁	何	壁	文徵
尹京	尹	京	兆之
孫承恩	孫	承恩	貞甫
廖慶	廖	慶	體善
徐之鸞	徐	之鸞	瑞卿
王蓂	王	蓂	時禎
伍箕	伍	箕	朝輝
賀縉	賀	縉	朝卿
高鵬	高	鵬	雲翼
張璿	張	璿	舜用
汪必東	汪	必東	希會
汪珊	汪	珊	德聲
南大吉	南	大吉	元善
翁洪 	翁	洪 	守洪
蔣淦	蔣	淦	汝潔
李杲	李	杲	孟寅
劉泉	劉	泉	應占
林文俊	林	文俊	汝英
沈圻	沈	圻	子京
劉校	劉	校	宗夏
孫紹祖	孫	紹祖	遠宗
劉景宇	劉	景宇	參之
劉成德	劉	成德	潤之
趙官	趙	官	惟賢
郝鳳升	郝	鳳升	瑞卿
張士鎬	張	士鎬	景周
金鯉	金	鯉	時躍
馬性魯	馬	性魯	進之
王璽 	王	璽 	□
姚文清	姚	文清	廉夫
戴顒	戴	顒	師觀
宋鉞	宋	鉞	德威
王江	王	江	宗岷
張文明	張	文明	應奎
何鉞	何	鉞	勳伯
范輅	范	輅	以載
楊必進	楊	必進	抑之
劉文瑞 	劉	文瑞 	廷麟
張文澐	張	文澐	公素
王璽	王	璽	卿寶
馬朝卿 	馬	朝卿 	忠夫
劉欒	劉	欒	汝喬
樊繼祖	樊	繼祖	孝甫
周震	周	震	世亨
楊璨	楊	璨	仲玉
王瑋	王	瑋	美中
吳嘉聰	吳	嘉聰	惟德
劉一中	劉	一中	貫道
趙漢 	趙	漢 	鴻連
童綸	童	綸	廷言
潘倣	潘	倣	景哲
李長	李	長	復之
康世臣	康	世臣	良佐
汪文盛	汪	文盛	希周
喻茂堅	喻	茂堅	汝礪
朱寅	朱	寅	時九
周勳	周	勳	良弼
杜盛	杜	盛	子實
高仁	高	仁	□暘
汪本	汪	本	惟中
王溱	王	溱	公濟
金臯	金	臯	□卿
高文豸	高	文豸	廷直
向信	向	信	□誠
王雄	王	雄	文翀
翁素	翁	素	誠夫
伍希儒	伍	希儒	汝真
傅鑰	傅	鑰	希準
宋寅	宋	寅	惟清
歐陽嵩	歐陽	嵩	汝中
王以旂	王	以旂	十招
張澯	張	澯	景川
屈釴	屈	釴	秉鈞
潘漢	潘	漢	朝宗
劉禔	劉	禔	持美
竇明	竇	明	惟遠
吳惠	吳	惠	仁甫
孫懋 	孫	懋 	德夫
羅方 	羅	方 	循矩
徐文溥	徐	文溥	可大
賈啓	賈	啓	啓之
黃大源	黃	大源	與潔
簡輔	簡	輔	汝欽
史立誠	史	立誠	克明
桂蕚	桂	蕚	子實
陳霑	陳	霑	汝霖
陳良玉	陳	良玉	德夫
李時元	李	時元	伯生
鄒輗	鄒	輗	敏行
張應祺	張	應祺	元吉
粟登	粟	登	貞年
鄭德崇	鄭	德崇	道夫
李先芳	李	先芳	孟春
曹蘭	曹	蘭	德芳
金罍	金	罍	文薦
劉夔	劉	夔	舜弼
金符	金	符	信臣
沈光大	沈	光大	體行
唐濂	唐	濂	景之
何棠 	何	棠 	愛之
尹元	尹	元	體仁
孫方	孫	方	思行
葉忠	葉	忠	一之
張楷	張	楷	式甫
趙君琰	趙	君琰	文載
龔守愚	龔	守愚	師顏
郭維藩	郭	維藩	□夫
楊應奎	楊	應奎	文煥
余璦 	余	璦 	德夫
穆世傑	穆	世傑	文英
游璉	游	璉	世重
田荊	田	荊	廷友
李安之	李	安之	嘉靖
張翀 	張	翀 	習之
聶珙	聶	珙	周贄
余鑾	余	鑾	廷儀
鄭慕	鄭	慕	師舜
李校	李	校	彥甫
戴駁	戴	駁	允化
楊秉中	楊	秉中	用之
沈霽	沈	霽	子公
許翔鳳	許	翔鳳	國禎
嚴時泰	嚴	時泰	應階
蔣亨	蔣	亨	原貞
余瓚	余	瓚	君錫
陶麟	陶	麟	仁夫
李潤	李	潤	子雨
徐乾	徐	乾	建夫
胡佩	胡	佩	時鳴
謝珊	謝	珊	伯聲
傅檝	傅	檝	廷濟
鄭正義	鄭	正義	宜之
熊蘭	熊	蘭	天秀
董相	董	相	應期
任舜臣	任	舜臣	承華
劉廷簠	劉	廷簠	器重
李鳳	李	鳳	仲鳴
沈俊	沈	俊	人傑
張鏜 	張	鏜 	廷進
韓鸞	韓	鸞	應和
王元正	王	元正	舜卿
易瓚	易	瓚	廷用
曹珪	曹	珪	廷獻
龔進	龔	進	思忠
任洛	任	洛	仲伊
余守觀	余	守觀	尚賓
劉景沂 	劉	景沂 	同仁
陳寰	陳	寰	原大
李旦	李	旦	周輔
吳棟	吳	棟	子村
任德	任	德	主善
劉濟	劉	濟	汝楫
吳誾	吳	誾	朝言
楊朝鳳	楊	朝鳳	應時
石金	石	金	南仲
張衍慶	張	衍慶	仲承
歐珠	歐	珠	明甫
周叙	周	叙	子厚
張欽	張	欽	敬之
饒富	饒	富	弘濟
詹軾	詹	軾	敬之
劉翀	劉	翀	文翔
俞璋	俞	璋	朝相
黨承志	黨	承志	汝孝
鍾善經	鍾	善經	理夫
周清	周	清	□寧
王金	王	金	汝礪
戚雄	戚	雄	□英
祝弘舒	祝	弘舒	文□
貢珊	貢	珊	□
冼尙文 	冼	尙文 	質夫
李孟旭	李	孟旭	大昕
孫聰	孫	聰	用□
歐陽崑	歐陽	崑	□
晏珠	晏	珠	廷光
汪淵	汪	淵	景顏
劉士元	劉	士元	伯儒
盧瓊	盧	瓊	獻□
余翺	余	翺	大振
孟廷柯	孟	廷柯	培之
王宗源	王	宗源	志潔
李鎮	李	鎮	安□
郭五常	郭	五常	大經
蕭淮	蕭	淮	東之
陸時通	陸	時通	行之
侯位	侯	位	□
趙德剛	趙	德剛	崇節
謝源	謝	源	士潔
周廷用	周	廷用	子賢
陳烈	陳	烈	朝臣
龔大有	龔	大有	士謙
李階	李	階	升之
申理	申	理	伯溫
邊寭	邊	寭	□明
萬玘	萬	玘	宗玉
羅玉	羅	玉	□
徐晉	徐	晉	□
馮世昌	馮	世昌	□
潘錡	潘	錡	希和
鄭雲翔	鄭	雲翔	士鳳
常倫	常	倫	明卿
熊允懋	熊	允懋	□
王紀	王	紀	理卿
彭昉	彭	昉	□甫
頓銳	頓	銳	□
于桂	于	桂	□
樂選	樂	選	舜舉
陳洸	陳	洸	世傑
鄭浙	鄭	浙	文川
王完	王	完	□
俞集	俞	集	汝成
詹崇	詹	崇	東魯
楊濂	楊	濂	景周
臧相	臧	相	伯良
東郊	東	郊	希宋
劉夢熊	劉	夢熊	伯祥
黃國泰 	黃	國泰 	尚賢
鄭懋德	鄭	懋德	成昭
張漢卿	張	漢卿	元傑
金選 	金	選 	惟賢
孫漳	孫	漳	希學
程鵬	程	鵬	□里
張居仁	張	居仁	公甫
胡瓊	胡	瓊	國華
章綸	章	綸	□之
毛震	毛	震	□
張鰲山	張	鰲山	汝立
宋臣	宋	臣	以忠
王寧	王	寧	仲一
許鎧	許	鎧	□完
何邦憲	何	邦憲	宗尹
戴祥	戴	祥	應和
劉概	劉	概	平甫
彭應軫	彭	應軫	□徵
萬潮	萬	潮	汝信
俞敦	俞	敦	崇禮
李際元	李	際元	通甫
簡佐	簡	佐	□
何炌	何	炌	明世
鄭傑	鄭	傑	伯與
施德禎	施	德禎	天瑞
路直	路	直	敬夫
張琥	張	琥	宗器
周懋文	周	懋文	存質
方坤	方	坤	萬成
陳憲	陳	憲	伯度
蔣益	蔣	益	守謙
張學禮	張	學禮	以立
劉黼 	劉	黼 	廷章
康浩	康	浩	德充
張錄	張	錄	宗制
儲洵	儲	洵	平甫
李節義	李	節義	德周
王遵	王	遵	舜典
舒芬	舒	芬	國裳
倫以訓	倫	以訓	彥式
崔桐	崔	桐	□鳳
汪佃	汪	佃	有之
余承勛	余	承勛	懋昭
李士元	李	士元	伯大
陳良珍	陳	良珍	聘之
葉珩	葉	珩	鳴玉
陳璧	陳	璧	天瑞
宋欽	宋	欽	敬夫
文明	文	明	用晦
王綸	王	綸	廷言
李瑜	李	瑜	良卿
黃易	黃	易	伯貞
王舜漁	王	舜漁	于澤
江暉	江	暉	景孚
高尚賢	高	尚賢	大賓
顏木	顏	木	惟喬
王廷陳	王	廷陳	稚欽
王臬	王	臬	汝陳
汪應軫	汪	應軫	子宿
張懷	張	懷	德珍
張拱辰	張	拱辰	仰德
熊宇	熊	宇	元性
劉世盛	劉	世盛	子謙
黃待顯	黃	待顯	君俊
何鰲	何	鰲	巨卿
曹懷	曹	懷	于德
林遷喬	林	遷喬	遷于
陸金	陸	金	德如
蕭廷傑	蕭	廷傑	元功
藍渠	藍	渠	志張
儲昱	儲	昱	麗中
鄭憲	鄭	憲	有度
毛紹元	毛	紹元	仲仁
陳琛	陳	琛	思獻
南壽	南	壽	仁夫
王漸逵	王	漸逵	用儀
葉桂章	葉	桂章	叔晦
葉式	葉	式	成規
華湘	華	湘	源楚
馬汝驥	馬	汝驥	仲房
陳則清	陳	則清	君揚
詹瀚	詹	瀚	汝約
仵瑜	仵	瑜	忠甫
葉觀	葉	觀	國光
胡侍	胡	侍	承之
趙儒	趙	儒	廷文
汪思	汪	思	得之
王三錫	王	三錫	承恩
林文沛	林	文沛	維德
廖世昭	廖	世昭	師賢
劉景寅	劉	景寅	仲賓
胡廷祿	胡	廷祿	原學
許仁	許	仁	子居
史于光	史	于光	中裕
黃綰	黃	綰	公綬
劉昌	劉	昌	惟德
張璵	張	璵	叔美
陳沂	陳	沂	魯南
彭本用	彭	本用	汝玉
胡汭	胡	汭	舜居
林應驄	林	應驄	汝桓
儲良材	儲	良材	邦掄
張鯤	張	鯤	子魚
鄭源渙	鄭	源渙	與聚
劉雍	劉	雍	堯臣
張子衷	張	子衷	和甫
廖梯	廖	梯	雲卿
沈弘道	沈	弘道	伯充
葉應驄	葉	應驄	肅卿
陳煥	陳	煥	子文
楊淮	楊	淮	東川
歐陽必進	歐陽	必進	任夫
趙錦	趙	錦	文卿
劉世綸	劉	世綸	伯序
柴經	柴	經	季常
姜絅	姜	絅	幼章
王至善	王	至善	遠吉
高瀹	高	瀹	新之
張淮	張	淮	本豫
葛木	葛	木	仁甫
謝顯	謝	顯	宗文
邊仲	邊	仲	中父
顧遂	顧	遂	德伸
丘其仁	丘	其仁	主靜
戴鱀	戴	鱀	時重
胡宗明	胡	宗明	汝誠
李蘭	李	蘭	秀夫
鄺灝	鄺	灝	子元
史道	史	道	克弘
陳應之	陳	應之	君咸
卓居傅	卓	居傅	起巖
梅鶚	梅	鶚	幼和
何岩	何	岩	邦鎮
金廷瑞	金	廷瑞	信夫
陳毓賢	陳	毓賢	則英
陳煥	陳	煥	德章
王鳳靈	王	鳳靈	應時
郭叙	郭	叙	天倫
彭澤	彭	澤	仁卿
李珣	李	珣	五瑞
王鎔	王	鎔	時化
孔廕	孔	廕	德貽
徐一鳴	徐	一鳴	伯和
莊惟春	莊	惟春	元卿
朱可宗	朱	可宗	端夫
江珊	江	珊	國珍
車純	車	純	秉文
楊儀	楊	儀	仲立
婁志德	婁	志德	存仁
龍大有	龍	大有	道亨
祁敕	祁	敕	惟允
陳鈇	陳	鈇	功錫
許相卿	許	相卿	台仲
王尚志	王	尚志	承尹
劉士奇	劉	士奇	邦正
徐子俊	徐	子俊	世庸
柯維熊	柯	維熊	奇徵
王時柯	王	時柯	□英
夏言	夏	言	公謹
李紹賢	李	紹賢	崇德
顧濟	顧	濟	丹卿
高節	高	節	大節
王世祿	王	世祿	子延
劉穆	劉	穆	敬之
高璧	高	璧	德卿
賈璘	賈	璘	文璧
曾棠	曾	棠	方召
陳華	陳	華	朝譽
蔡宗兖	蔡	宗兖	希淵
裴紹宗	裴	紹宗	伯修
楊士雲	楊	士雲	從龍
朱豹	朱	豹	子文
曹鎡	曹	鎡	時用
楊翺	楊	翺	雲鳳
夏宗仁	夏	宗仁	以元
王鼎	王	鼎	汝調
林若周	林	若周	吾從
李惠	李	惠	德卿
馬紀	馬	紀	直卿
涂相	涂	相	夢卜
胡效才	胡	效才	汝愚
梁朝宗	梁	朝宗	東之
白珝	白	珝	德潤
王暐	王	暐	克明
楊瑀	楊	瑀	文珮
張邦教	張	邦教	以寬
汪溱	汪	溱	汝梁
劉一正	劉	一正	體道
蔡乾	蔡	乾	汝健
張希尹	張	希尹	子修
王官	王	官	惟人
劉訒	劉	訒	思存
徐岱	徐	岱	世瞻
李文	李	文	載道
陳相	陳	相	君輔
陳嘉謀	陳	嘉謀	仲詢
王可學	王	可學	時敏
侯秩	侯	秩	季常
伍餘福	伍	餘福	疇中
徐子龍	徐	子龍	中夫
謝旻	謝	旻	仁夫
柯相	柯	相	元卿
王崑	王	崑	希申
吳英	吳	英	文傑
張星	張	星	子陽
金樸	金	樸	□□
廖𠳲	廖	𠳲	儀仲
宋銳	宋	銳	進之
范鏓	范	鏓	平甫
鄧繼曾	鄧	繼曾	士魯
熊榮	熊	榮	以仁
范紳	范	紳	縉卿
季本	季	本	明德
王納言	王	納言	允忠
劉㝡	劉	㝡	振廷
馬冕	馬	冕	文中
桑仟	桑	仟	宗之
王正宗	王	正宗	適夫
吳琦	吳	琦	汝器
蔡經	蔡	經	廷彝
李東	李	東	震卿
戴繼先	戴	繼先	承緒
朱洸	朱	洸	大武
秦武	秦	武	從熙
龐淳	龐	淳	宗厚
鄧鉞	鄧	鉞	邦靖
詹珪	詹	珪	朝章
陳大道	陳	大道	敬之
葛蘭	葛	蘭	時秀
吳仲	吳	仲	亞甫
任佃	任	佃	象虞
劉宏愚	劉	宏愚	克明
劉漳	劉	漳	允濟
王胤賢	王	胤賢	紹先
沈松	沈	松	如松
林茂竹	林	茂竹	仲修
蔣珙	蔣	珙	國信
趙焱	趙	焱	光霽
孫峻	孫	峻	克明
高軒	高	軒	文載
林公黼	林	公黼	質夫
楊鏊	楊	鏊	時濟
潘銳	潘	銳	宗魯
劉黻	劉	黻	伯繡
楊秦	楊	秦	濟之
張岳	張	岳	維喬
蕭與成	蕭	與成	宗樂
陳萬言	陳	萬言	子約
方瀾	方	瀾	思源
傅南喬	傅	南喬	梁器
袁淮	袁	淮	伯昭
林時	林	時	懋易
鄭自壁	鄭	自壁	采東
劉世揚	劉	世揚	實夫
杜民表	杜	民表	望之
宋沂	宋	沂	希曾
馬津	馬	津	宗孔
張淮	張	淮	景禹
陳良謨	陳	良謨	忠夫
王冕	王	冕	服周
朱鼐	朱	鼐	朝和
田秀	田	秀	子實
程資	程	資	仲朴
謝誥	謝	誥	朝制
張淮	張	淮	豫卿
吳世良	吳	世良	邦貞
吾謹	吾	謹	惟可
陳直	陳	直	遂初
張濂	張	濂	景周
曹嘉	曹	嘉	仲禮
李士允	李	士允	子中
司迪	司	迪	允吉
閻閎	閻	閎	尚友
姚汝臯	姚	汝臯	舜卿
王懋	王	懋	昭大
畢張	畢	張	宿夫
吳鼎	吳	鼎	維新
魯綸	魯	綸	孔言
葉竦	葉	竦	喬新
丁瓚	丁	瓚	敬夫
郭波	郭	波	澄卿
高夔	高	夔	舜臣
牟盛	牟	盛	汝登
季方	季	方	子坤
陳大器	陳	大器	國成
顧鐸	顧	鐸	孔振
王泮	王	泮	文淵
李秉仁	李	秉仁	元夫
王莘	王	莘	元聘
尹嗣忠	尹	嗣忠	子貞
胡譽	胡	譽	實孚
王翰臣	王	翰臣	文佐
秦祐	秦	祐	順甫
王舜耕	王	舜耕	于田
郭夢麒	郭	夢麒	徵甫
湯惟學	湯	惟學	時敏
李順孫	李	順孫	繼先
周臣	周	臣	藎臣
俞夔	俞	夔	舜臣
顧昺	顧	昺	仲光
張曰韜	張	曰韜	席珍
倪鶚	倪	鶚	子薦
江元輔	江	元輔	堯卿
李煌	李	煌	德融
麻漳	麻	漳	汝清
張寶	張	寶	君信
黎貫	黎	貫	一卿
蕭一中	蕭	一中	執夫
方紀達	方	紀達	行可
諸偁	諸	偁	揚伯
鄭洛書	鄭	洛書	啟範
聶豹	聶	豹	文蔚
趙光	趙	光	仲熙
白麒	白	麒	子仁
徐錦	徐	錦	章父
陳逅	陳	逅	良會
席春	席	春	仁同
楊天祥	楊	天祥	休徵
陳綬	陳	綬	綰卿
劉乾亨	劉	乾亨	汝嘉
牟泰	牟	泰	以貞
張仝節	張	仝節	一中
暢華	暢	華	子實
母德純	母	德純	惟一
王光濟	王	光濟	謙夫
蘇信	蘇	信	宗王
薛侃	薛	侃	尚謙
鍾雲瑞	鍾	雲瑞	天慶
王天民	王	天民	子行
楊茂	楊	茂	叔亨
林仕鳳	林	仕鳳	鳴盛
張瀚	張	瀚	時涵
林希元	林	希元	茂貞
孫舟	孫	舟	取渙
劉淮	劉	淮	東□
王瑄	王	瑄	子成
李鶴鳴	李	鶴鳴	九臯
周惠	周	惠	字民
謝元順	謝	元順	德和
姚鳴鳳	姚	鳴鳳	景陽
林春	林	春	德元
王文	王	文	純卿
張嵩	張	嵩	中望
黎良	黎	良	性之
譚纘	譚	纘	元孝
王邦瑞	王	邦瑞	惟賢
陳大綱	陳	大綱	廷憲
劉祺	劉	祺	吉甫
黃相	黃	相	國佐
許宗魯	許	宗魯	伯誠
許中	許	中	伯時
章僑	章	僑	處仁
榮察	榮	察	省夫
鄭建	鄭	建	一中
彭文	彭	文	相道
曹弘	曹	弘	毅之
浦鋐	浦	鋐	汝器
曹輻	曹	輻	子進
王朝瑬	王	朝瑬	仲冕
戴玉成	戴	玉成	孝章
徐官	徐	官	伯賢
周詔	周	詔	廷綸
高鵬	高	鵬	汝南
蔣舜民	蔣	舜民	虞中
趙璵	趙	璵	魯珍
劉燁然	劉	燁然	文光
劉謙亨	劉	謙亨	汝撝
王祐	王	祐	順卿
楊瑞	楊	瑞	帷賢
李傑	李	傑	伯奇
熊元	熊	元	孟才
郭希愈	郭	希愈	遜卿
白玶	白	玶	良甫
王汝梅	王	汝梅	濟元
藺益	藺	益	汝謙
沈濙	沈	濙	子源
郭持平	郭	持平	守衡
楊永祜	楊	永祜	元錫
張芊	張	芊	廷茂
翟璘	翟	璘	潤卿
王謳	王	謳	舜夫
臧應奎	臧	應奎	賢徵
張文奎	張	文奎	應光
朱臣	朱	臣	升伯
楊概	楊	概	孔平
陸澄	陸	澄	元靜
鄭漳	鄭	漳	世績
楊維聰	楊	維聰	達甫
陸釴	陸	釴	舉之
費懋中	費	懋中	民□
廖道南	廖	道南	鳴吾
江汝璧	江	汝璧	懋穀
詹泮	詹	泮	文化
王積	王	積	子崇
沈漢	沈	漢	宗海
鄭一鵬	鄭	一鵬	九萬
陳騰鸞	陳	騰鸞	士遠
史梧	史	梧	文材
童承敘	童	承敘	士疇
朱藻	朱	藻	以薦
黃佐	黃	佐	才伯
趙廷瑞	趙	廷瑞	信臣
黃大經	黃	大經	道卿
張羽	張	羽	子漸
張逵	張	逵	懋登
劉臬	劉	臬	憲甫
張鳳來	張	鳳來	千廷
朱衣	朱	衣	子宜
鄭騮	鄭	騮	德夫
杜桐	杜	桐	子陽
方縉	方	縉	時彥
富好禮	富	好禮	子超
王相	王	相	懋賢
鄭登高	鄭	登高	曰進
徐嵩	徐	嵩	中望
陳璜	陳	璜	佩之
安璽	安	璽	君信
胡森	胡	森	秀夫
馮轍	馮	轍	時憲
洪珠	洪	珠	玉方
黃一道	黃	一道	唯夫
杜柟	杜	柟	子彥
吳廷翰	吳	廷翰	崧伯
胡昭	胡	昭	原明
李浙	李	浙	邦秀
侯廷訓	侯	廷訓	孟學
龔亨	龔	亨	有孚
瞿祥	瞿	祥	治徵
吳章	吳	章	成甫
李坦	李	坦	公循
敖英	敖	英	子發
袁城	袁	城	邦衛
景溱	景	溱	濟之
黃行可	黃	行可	兆見
王世芳	王	世芳	濟美
何棟	何	棟	伯直
王煒	王	煒	克新
惲釜	惲	釜	器之
劉世龍	劉	世龍	允卿
錢際時	錢	際時	清仲
杜紹	杜	紹	述之
劉渠	劉	渠	清甫
羅洪載	羅	洪載	道與
高汝行	高	汝行	□古
葛鴊	葛	鴊	子中
張治	張	治	子邦
高登	高	登	從善
徐顥	徐	顥	子淳
李嶽鍾	李	嶽鍾	天毓
徐曰忠	徐	曰忠	公輔
朱應昌	朱	應昌	時濟
丘茂中	丘	茂中	子時
林益	林	益	民悅
吳縉	吳	縉	雲卿
蕭晚	蕭	晚	啓旦
王楊	王	楊	惟直
張寰	張	寰	允清
朱紈	朱	紈	子純
張承恩	張	承恩	君賜
陳賞	陳	賞	邦□
邵燁	邵	燁	悳明
張袞	張	袞	補之
張璁	張	璁	秉用
李香	李	香	汝蘭
查應兆	查	應兆	瑞徵
李錄	李	錄	貢卿
潘鎰	潘	鎰	希平
邵經邦	邵	經邦	仲德
張羽	張	羽	子儀
謝霖	謝	霖	世澤
王大化	王	大化	玄成
王道	王	道	伯行
司馬相	司馬	相	邦柱
劉仕	劉	仕	以學
劉可	劉	可	以中
王同祖	王	同祖	繩武
吳瀚	吳	瀚	受夫
張緯	張	緯	文之
孟易	孟	易	希周
郗元洪	郗	元洪	文範
汪堅	汪	堅	子固
李佶	李	佶	子健
倫以諒	倫	以諒	彥周
於敖	於	敖	伯度
黃表	黃	表	汝明
蔣泮	蔣	泮	良化
盧煥	盧	煥	堯文
洪鏘	洪	鏘	鳴雍
周瑯	周	瑯	光載
楊撫	楊	撫	安世
姚正	姚	正	在養
詹寬	詹	寬	仁量
舒林	舒	林	惟喬
王化	王	化	子涵
初杲	初	杲	啟昭
王用賓	王	用賓	允興
朱珮	朱	珮	鳴朝
劉喬	劉	喬	于僊
魏珽	魏	珽	直甫
鍾潛	鍾	潛	孔昭
邵煉	邵	煉	悳成
梁世驃	梁	世驃	應房
王汝賓	王	汝賓	尚賢
史立模	史	立模	季弘
杜璲	杜	璲	汝鳴
王洙	王	洙	崇敬
楊旦	楊	旦	啟東
柴儒	柴	儒	伯真
朱孔陽	朱	孔陽	公裳
觧一貴	觧	一貴	曾唯
王密	王	密	君德
陳講	陳	講	子學
高世魁	高	世魁	紹甫
鄒瓉	鄒	瓉	獻卿
李鳳來	李	鳳來	德儀
李章	李	章	民俊
林介	林	介	子石
浦瑾	浦	瑾	文玉
吳鯨	吳	鯨	龍化
佟應龍	佟	應龍	司言
徐子貞	徐	子貞	善正
丘養浩	丘	養浩	以義
劉序	劉	序	元禮
潘潢	潘	潢	屬叔
趙葉	趙	葉	子玉
姚激	姚	激	維清
王科	王	科	進卿
楊彛	楊	彛	宗敘
林釴	林	釴	克相
趙章	趙	章	達卿
吳檄	吳	檄	用宣
胡仲謨	胡	仲謨	啟忠
張寅	張	寅	仲明
嚴志迪	嚴	志迪	子善
劉儒道	劉	儒道	惟中
孫昂	孫	昂	一鶴
孫應奎	孫	應奎	文宿
周綡	周	綡	仲饌
湯虺	湯	虺	仲卿
朱雲鳳	朱	雲鳳	瑞卿
林成	林	成	世玉
李默	李	默	時言
吳良輔	吳	良輔	遂卿
姜文	姜	文	質夫
周文熯	周	文熯	宗陽
胡偉	胡	偉	邦奇
余鋟	余	鋟	文甫
葉逢陽	葉	逢陽	子美
劉道	劉	道	子弘
高淺	高	淺	升之
焦昇	焦	昇	景和
楊麒	楊	麒	仁甫
姚鳴鸞	姚	鳴鸞	景雍
王朝用	王	朝用	行甫
趙永淳	趙	永淳	德厚
朱鴻漸	朱	鴻漸	子羽
洪萬立	洪	萬立	道充
劉恩	劉	恩	以忠
李春芳	李	春芳	實夫
吳文之	吳	文之	與成
朱子和	朱	子和	節之
侯緘	侯	緘	世言
施山	施	山	鎮卿
郁山	郁	山	子靜
賈世祥	賈	世祥	國興
董進第	董	進第	子庸
丘九仞	丘	九仞	時進
張問行	張	問行	子書
杜蕙	杜	蕙	維馨
葉亹	葉	亹	世黽
穆相	穆	相	伯寅
顧陽和	顧	陽和	志仁
董中言	董	中言	慎巳
鲍說	鲍	說	希傅
羅尚愛	羅	尚愛	以德
施一德	施	一德	子脩
趙兌	趙	兌	麗卿
余經	余	經	崇一
楊仲瓊	楊	仲瓊	子石
胡體乾	胡	體乾	健夫
張珩	張	珩	佩玉
陳邦敷	陳	邦敷	自寬
楊宗堯	楊	宗堯	從道
丁汝虁	丁	汝虁	大章
鄒架	鄒	架	大升
江山	江	山	仁伯
王世爵	王	世爵	君列
應棐	應	棐	子忠
倪宗嶽	倪	宗嶽	鎮卿
景仲光	景	仲光	文華
晆紘	晆	紘	朝冕
孫燦	孫	燦	晦孺
楊言	楊	言	惟仁
陳由正	陳	由正	楷卿
田麟	田	麟	文祥
張恂	張	恂	醇夫
常泰	常	泰	時雍
孫益	孫	益	德謙
端廷赦	端	廷赦	世恩
金輅	金	輅	之秉
譚誾	譚	誾	朝言
趙時寧	趙	時寧	康伯
藍伯采	藍	伯采	本素
胡明善	胡	明善	公澤
陳大濩	陳	大濩	則啟
楊迥	楊	迥	俊卿
王繼禮	王	繼禮	行之
石國柱	石	國柱	殿卿
李松	李	松	節夫
田龍	田	龍	起潛
田頊	田	頊	希古
陳皐謨	陳	皐謨	名世
徐元祉	徐	元祉	良夫
劉逈	劉	逈	維中
尹倫	尹	倫	天敘
高應禎	高	應禎	貞甫
楊鏞	楊	鏞	聲之
項熙	項	熙	朝載
陸鰲	陸	鰲	伯載
謝蕡	謝	蕡	惟盛
方啟顏	方	啟顏	叔希
張徽	張	徽	德卿
李翔	李	翔	集卿
屈儒	屈	儒	女為
蔣詔	蔣	詔	伯宣
王鳴鳳	王	鳴鳳	時瑞
段汝礪	段	汝礪	良臣
周煦	周	煦	啟和
彭汝寔	彭	汝寔	子兗
蔣暘	蔣	暘	文輝
張佑	張	佑	吉孚
梁喬升	梁	喬升	以順
鄭節	鄭	節	介甫
傅仲霖	傅	仲霖	民望
劉濂	劉	濂	濬伯
黃仁山	黃	仁山	元靜
劉宗諫	劉	宗諫	子忠
何鐘	何	鐘	以宣
徐昭	徐	昭	德新
曾梧	曾	梧	于陽
王紀	王	紀	朝憲
張祿	張	祿	原學
裴騫	裴	騫	子孝
馬敭	馬	敭	抑之
沈奎	沈	奎	文瑞
胡奎	胡	奎	應文
田玉	田	玉	德溫
熊爵	熊	爵	子脩
陳貴	陳	貴	道充
劉熇	劉	熇	德輝
王朝用	王	朝用	汝行
曾世昌	曾	世昌	公裕
龐浩	龐	浩	師孟
趙鏜	趙	鏜	振夫
劉竹	劉	竹	守節
毛麟之	毛	麟之	仁甫
黃潤	黃	潤	以誠
周祚	周	祚	天保
王重賢	王	重賢	子尚
潘泗	潘	泗	源魯
顧溱	顧	溱	梁卿
吳瀛	吳	瀛	萃夫
毛鳳韶	毛	鳳韶	瑞成
張鳳翀	張	鳳翀	文彩
張璠	張	璠	廷珍
谷鸞	谷	鸞	應和
蔡復元	蔡	復元	淑仁
王銳	王	銳	子中
楊叔器	楊	叔器	德周
張經綸	張	經綸	以時
李綸	李	綸	正言
周虁	周	虁	公遜
吳大本	吳	大本	性夫
楊珮	楊	珮	仲玉
顏明復	顏	明復	學夫
陳時明	陳	時明	際豐
張𦐿	張	𦐿	騰漢
王傅	王	傅	孟學
宗良臣	宗	良臣	敬之
徐俊民	徐	俊民	達夫
方鈍	方	鈍	仲敏
周朝俛	周	朝俛	勤可
廖自顯	廖	自顯	德潛
王芳	王	芳	元采
雷子質	雷	子質	仲華
張惟恕	張	惟恕	子行
袁士偉	袁	士偉	彥夫
杜鸞	杜	鸞	文祥
任淳	任	淳	原朴
楊琰	楊	琰	用思
鄭重	鄭	重	子任
劉守良	劉	守良	君遂
李茂元	李	茂元	維大
魏有本	魏	有本	伯深
程輅	程	輅	邦載
葉泰	葉	泰	道亨
孫鑾	孫	鑾	朝望
黃國光	黃	國光	尚賓
韋尚賢	韋	尚賢	思肖
呂綸	呂	綸	君言
王璜	王	璜	廷實
葉奇	葉	奇	弘偉
湯冔	湯	冔	伯元
戴亢	戴	亢	師賢
繆宗周	繆	宗周	惟靜
爼琚	爼	琚	佩章
錢鐸	錢	鐸	振之
管律	管	律	應韶
仲選	仲	選	思舜
龔大稔	龔	大稔	士登
余文瑞	余	文瑞	一麟
劉希稷	劉	希稷	農卿
華金	華	金	子宣
馬鐸	馬	鐸	彥聲
林誌	林	誌	尚默
王鈺	王	鈺	孟堅
戴乾	戴	乾	自強
饒安	饒	安	用中
劉翀	劉	翀	雲高
劉咸	劉	咸	士皆
鄭閻	鄭	閻	公望
揚伸	揚	伸	孟舒
鮑英	鮑	英	育之
陳端	陳	端	執中
孫曦	孫	曦	明遠
鄭阜義	鄭	阜義	公宜
黃澤	黃	澤	孚仲
顧巽	顧	巽	與惓
蔣禮	蔣	禮	敬之
楊政	楊	政	惟效
郭公緒	郭	公緒	公緒
盧質中	盧	質中	質中
曾鼎	曾	鼎	復鉉
章睿	章	睿	左奎
趙勗	趙	勗	士勉
陳原祐	陳	原祐	本孚
劉長吾	劉	長吾	
檀凱	檀	凱	伯和
張思安	張	思安	克讓
江殷	江	殷	孔殷
黎恬	黎	恬	潛輝
黃翰	黃	翰	汝申
徐俊	徐	俊	勢傑
錢述	錢	述	稽穡
陳琦	陳	琦	公琰
吳賜	吳	賜	希貢
黃彥	黃	彥	時俊
張璘	張	璘	文玉
徐則寧	徐	則寧	從政
何賢	何	賢	彥哲
于庭頤	于	庭頤	耆英
陳禮	陳	禮	正言
胡守宗 	胡	守宗 	穆中
楊勳	楊	勳	功讓
熊倫	熊	倫	仲彜
黃常祖	黃	常祖	邦經
鞠祥	鞠	祥	茂慶
高第	高	第	仲賢
潘勤	潘	勤	進學
林文澧	林	文澧	有蘭
吳潛	吳	潛	蔵伯
羅惟政	羅	惟政	景辰
趙禮	趙	禮	秉禮
傅啟讓 	傅	啟讓 	仲禮
傅玉潤	傅	玉潤	玉潤
黃裳	黃	裳	文中
羅興	羅	興	起善
余文	余	文	孟質
楊榮	楊	榮	子仁
顏澤	顏	澤	澤民
任用	任	用	庭輝
王嗣先	王	嗣先	嗣先
胡敬	胡	敬	彥學
林密	林	密	子茂
張觀	張	觀	尚賓
蔡道隆	蔡	道隆	希阜
陽清	陽	清	景廉
倪良	倪	良	大成
胡璉	胡	璉	維琛
王觀 	王	觀 	庭賓
史循	史	循	公序
周常	周	常	茂永
林碩	林	碩	懋弘
史詠	史	詠	永言
張紹	張	紹	繼之
陶仕宗	陶	仕宗	逢原
李庠	李	庠	弘文
王詢	王	詢	命我
陳正倫 	陳	正倫 	正倫
葉俊	葉	俊	肅英
凌輝	凌	輝	邦輝
吳誠	吳	誠	士立
馬馴	馬	馴	至善
王時習	王	時習	勉學
王璜	王	璜	子玉
翟彥俊	翟	彥俊	用章
阮存	阮	存	以禮
熊自誠	熊	自誠	自誠
彭眘	彭	眘	孝常
劉濬	劉	濬	子深
楊昺	楊	昺	文昭
徐行	徐	行	同倫
謝忱	謝	忱	惟壽
羅通 	羅	通 	學古
葉冝	葉	冝	守義
陳鎰	陳	鎰	有戒
傅玉良	傅	玉良	玉良
李濬	李	濬	大川
蔣疇	蔣	疇	嗣昭
陳潤	陳	潤	澤民
劉璉	劉	璉	宗華
胡讓 	胡	讓 	仲遜
陳遜	陳	遜	必恭
邵暹	邵	暹	賓旭
王凱	王	凱	叔和
歐陽和	歐陽	和	永和
米顯	米	顯	遂良
施琰 	施	琰 	文壁
方復	方	復	文英
羅洪先	羅	洪先	達夫
程文德	程	文德	舜敷
楊名	楊	名	實卿
唐順之	唐	順之	應德
陳束	陳	束	約之
任瀚	任	瀚	少海
陳節之	陳	節之	尹和
胡經	胡	經	用甫
夏寶	夏	寶	楚善
李聯芳	李	聯芳	伯實
何鮤	何	鮤	子時
栗應麟	栗	應麟	仁甫
盧淮	盧	淮	北紀
王學益	王	學益	虞卿
項喬	項	喬	遷之
朱麟	朱	麟	子仁
鄭絅	鄭	絅	子尚
梁懷仁	梁	懷仁	宅之
諸邦憲	諸	邦憲	貞伯
汪大受	汪	大受	叔可
謝紘	謝	紘	天章
王三錫	王	三錫	汝懷
郭宗臯	郭	宗臯	君弼
涂楗	涂	楗	良翰
張旍	張	旍	邦建
胡松	胡	松	汝茂
吳逵	吳	逵	近光
黃卷	黃	卷	景文
戴銑	戴	銑	子聲
鄭慶	鄭	慶	有章
黎晨	黎	晨	光啟
孫雲	孫	雲	從龍
蔡雲程	蔡	雲程	亨之
陳詞	陳	詞	子達
楊祜	楊	祜	汝承
鄭世威	鄭	世威	中孚
陳茂義	陳	茂義	時卿
洪富	洪	富	國昌
潘徽	潘	徽	叔慎
郟鼎	郟	鼎	薦和
周臣	周	臣	子忠
費淵	費	淵	汝進
張意	張	意	誠之
高鸞	高	鸞	應治
汪文淵	汪	文淵	養靜
王表	王	表	邦正
曹汴	曹	汴	子東
王穀祥	王	穀祥	祿之
程烈	程	烈	惟光
安永清	安	永清	汝澄
熊過	熊	過	叔仁
安如山	安	如山	子靜
蔡克廉	蔡	克廉	道卿
方涯	方	涯	汝濟
張文藻	張	文藻	美中
薛甲	薛	甲	應登
趙鑾	趙	鑾	鳴和
李祦	李	祦	仲謙
李玘	李	玘	文甫
楊本仁	楊	本仁	次山
常時平	常	時平	允升
錢世賢	錢	世賢	信夫
王養正	王	養正	伯純
劉采	劉	采	與質
王希文	王	希文	景純
沈愷	沈	愷	舜臣
李易	李	易	仲占
周志偉	周	志偉	士器
郭春震	郭	春震	以亨
李開先	李	開先	伯華
蔣芝	蔣	芝	世和
鍾卿	鍾	卿	懋敬
鄭觀	鄭	觀	汝中
任洧	任	洧	清之
陳之輔	陳	之輔	伯棐
樊臣	樊	臣	以忠
曾翀	曾	翀	習之
楊守謙	楊	守謙	允亨
陳大壯	陳	大壯	子晉
王仲錦	王	仲錦	絅之
汪似	汪	似	克有
黃福	黃	福	子謙
蔣貫	蔣	貫	起中
張材	張	材	子成
王納言	王	納言	惟允
劉伯躍	劉	伯躍	起之
王正思	王	正思	仲行
鮑象賢	鮑	象賢	復之
呂高	呂	高	思抑
莊一俊	莊	一俊	君棐
趙文華	趙	文華	原實
王䋊	王	䋊	少儀
胡萬里	胡	萬里	伯明
羅餘慶	羅	餘慶	道承
盧輔	盧	輔	仲立
王培齡	王	培齡	延甫
孟雷	孟	雷	孔敬
潘大賓	潘	大賓	欽之
翟鏡	翟	鏡	秉明
吳㻞	吳	㻞	汝文
董雍	董	雍	肅卿
孫應奎	孫	應奎	文卿
鄭大同	鄭	大同	皆吾
楊爵	楊	爵	伯修
沈謐	沈	謐	靖夫
周汝員	周	汝員	文規
柯喬	柯	喬	遷之
孫世祐	孫	世祐	元吉
李中孚	李	中孚	化卿
李實	李	實	希大
莊用賓	莊	用賓	君采
孫光輝	孫	光輝	華國
李良	李	良	遂甫
李逢	李	逢	邦吉
魏煥	魏	煥	原德
王宗恒	王	宗恒	季高
曹世盛	曹	世盛	際卿
侯寧	侯	寧	懷德
魏一恭	魏	一恭	道莊
吳子孝	吳	子孝	純叔
王滋	王	滋	思益
葛守禮	葛	守禮	與立
危嶽	危	嶽	繼申
錢煥	錢	煥	叔晦
賈凖	賈	凖	惟一
杜彰	杜	彰	德明
陳釴	陳	釴	惟鉉
張勑	張	勑	汝欽
王鉅	王	鉅	德卿
曾銑	曾	銑	子重
胡思忠	胡	思忠	進之
朱德禎	朱	德禎	必興
丁柷	丁	柷	汝和
崔三畏	崔	三畏	敬父
王紳	王	紳	子書
舒國光	舒	國光	賓之
邵新	邵	新	循善
白世卿	白	世卿	汝衡
彭端遇	彭	端遇	時可
翁溥	翁	溥	德宏
林性之	林	性之	帥吾
張選	張	選	舜舉
高仲福	高	仲福	壽卿
孔泗	孔	泗	宗魯
張舜元	張	舜元	伯才
楊愽	楊	愽	惟約
徐九臯	徐	九臯	遠卿
鍾鑑	鍾	鑑	爾正
徐濙	徐	濙	景禹
馮彬	馮	彬	用先
林恕	林	恕	道近
張忠	張	忠	顯父
陶廉	陶	廉	敬甫
趙塤	趙	塤	平仲
趙九思	趙	九思	敬夫
胡俸	胡	俸	君錫
左傑	左	傑	允興
張文鳳	張	文鳳	公儀
朱深	朱	深	淵甫
周顯宗	周	顯宗	子孝
林梅	林	梅	以和
田濡	田	濡	少生
蔡靉	蔡	靉	天章
眭燁	眭	燁	子蘊
莊壬春	莊	壬春	子仁
趙康	趙	康	惟幾
林允宗	林	允宗	希曾
趙元夫	趙	元夫	企仁
王銳	王	銳	養之
劉瑜	劉	瑜	貴卿
朱冕	朱	冕	文中
呂調羹	呂	調羹	夢卿
林山	林	山	士仁
夏浚	夏	浚	惟明
原寀	原	寀	次寮
曾守約	曾	守約	子如
饒中	饒	中	性甫
孟霦	孟	霦	孔章
徐宗魯	徐	宗魯	希曾
謝載	謝	載	子坤
楊逢春	楊	逢春	仁甫
高大經	高	大經	以仁
張環	張	環	孟循
李鳳	李	鳳	鳴叔
柳本明	柳	本明	誠甫
謝崑	謝	崑	鍾璞
邢如默	邢	如默	宣甫
方舟	方	舟	時濟
李汝楫	李	汝楫	濟卿
吳本固	吳	本固	道深
楊時泰	楊	時泰	道亨
林東海	林	東海	世觀
陳光華	陳	光華	道蘊
劉鳳	劉	鳳	鳴岐
周洪範	周	洪範	伯陳
錢澍	錢	澍	天澤
李延馨	李	延馨	允明
曹逵	曹	逵	履中
張明道	張	明道	希程
白賁	白	賁	亨甫
陳蕙	陳	蕙	邦馨
張鎬	張	鎬	叔京
李全	李	全	求全
石遷高	石	遷高	謙甫
任廷貴	任	廷貴	君爵
張鳧	張	鳧	羽卿
閻鄰	閻	鄰	德甫
陳珪	陳	珪	禹成
林繼臯	林	繼臯	德謨
許勉仁	許	勉仁	希顏
黃訓	黃	訓	學古
趙鯤	趙	鯤	于南
寇陽	寇	陽	體乾
丘峻	丘	峻	惟渉
楊沔	楊	沔	東之
孫濟	孫	濟	以道
丘汝良	丘	汝良	民牧
李棟	李	棟	植卿
林壁	林	壁	茂東
何偁	何	偁	邦美
褚寶	褚	寶	光楚
陳錠	陳	錠	敬輿
江東	江	東	伯陽
閻倬	閻	倬	允章
胡永成	胡	永成	思貞
江滿	江	滿	謙之
歐思誠	歐	思誠	純甫
陳公陞	陳	公陞	伯舉
賀府	賀	府	應壁
劉塾	劉	塾	汝學
丁湛	丁	湛	子一
倪嵩	倪	嵩	中卿
高懋	高	懋	惟德
朱隆禧	朱	隆禧	子謙
程尚寧	程	尚寧	廷德
李寧	李	寧	懷德
錢璧	錢	璧	和玉
陳儒	陳	儒	子醇
張鈇	張	鈇	德威
黃綬	黃	綬	公佩
陳念	陳	念	功父
郭從朴	郭	從朴	文伯
菅懷理	菅	懷理	一初
陳昌福	陳	昌福	子隆
黃正色	黃	正色	士尚
黃允謙	黃	允謙	汝益
張濟	張	濟	汝楫
馬練	馬	練	元素
羅傅	羅	傅	次卿
曹濡	曹	濡	汝育
李朝列	李	朝列	長卿
詹文光	詹	文光	用賓
葉洪	葉	洪	子源
祝詠	祝	詠	鳴盛
王崇	王	崇	仲德
馬書林	馬	書林	子約
王璣	王	璣	在叔
張溪	張	溪	伯清
謝應嶽	謝	應嶽	顯之
劉昺	劉	昺	晉初
周如底	周	如底	允直
劉鳳翔	劉	鳳翔	仲集
張鵬翼	張	鵬翼	雲程
李士文	李	士文	在中
戴繼	戴	繼	淑似
金清	金	清	廉夫
章允賢	章	允賢	汝愚
張裕	張	裕	士弘
茅宰	茅	宰	治卿
郝維嶽	郝	維嶽	叔望
羅虞臣	羅	虞臣	熙載
王鎬	王	鎬	宗周
卞偉	卞	偉	子充
高進	高	進	維藎
王與齡	王	與齡	受甫
陳捷	陳	捷	仲遲
范來賢	范	來賢	昌國
沈鐸	沈	鐸	時振
皇甫汸	皇甫	汸	子循
陳大綸	陳	大綸	伯言
吳孟祺	吳	孟祺	元壽
王汝楫	王	汝楫	利民
張志選	張	志選	以學
杜朝聘	杜	朝聘	莘夫
馮惠	馮	惠	天祐
喬佑	喬	佑	德徵
饒思聰	饒	思聰	子聞
張烜	張	烜	仲熙
郭應奎	郭	應奎	致祥
高簡	高	簡	公敬
唐時英	唐	時英	子才
陳子文	陳	子文	在中
李遂	李	遂	良伯
黃光昇	黃	光昇	明舉
許繹	許	繹	士成
路珠	路	珠	子明
趙國良	趙	國良	邦遂
榮愷	榮	愷	舜舉
郭圻	郭	圻	維望
王祚	王	祚	永錫
李紳	李	紳	朝儀
高擢	高	擢	士元
張嘉秀	張	嘉秀	文英
陳一貫	陳	一貫	魯得
徐謙	徐	謙	子恭
吳介	吳	介	子正
汪宗元	汪	宗元	子允
孫應辰	孫	應辰	拱極
趙瀛	趙	瀛	文海
鄭恭	鄭	恭	子安
高澄	高	澄	肅卿
劉希龍	劉	希龍	汝言
周相	周	相	君弼
白濬	白	濬	子深
徐泮	徐	泮	崇教
曹察	曹	察	明卿
楊獻可	楊	獻可	子襄
龔湜	龔	湜	茂揚
黃謹容	黃	謹容	望之
徐存義	徐	存義	質夫
陳洙	陳	洙	道源
王杏	王	杏	世文
沈師賢	沈	師賢	德秀
林大欽	林	大欽	敬夫
孔天胤	孔	天胤	汝錫
高節	高	節	公成
李啟東	李	啟東	元叔
熊洛	熊	洛	景之
桑喬	桑	喬	子木
黃崋	黃	崋	秀卿
楊瀹	楊	瀹	弘功
張合	張	合	懋觀
林春	林	春	子仁
王廷	王	廷	子正
張冕	張	冕	服周
顧四科	顧	四科	齊賢
賈士元	賈	士元	仁甫
俞咨伯	俞	咨伯	禮卿
顧玉柱	顧	玉柱	邦石
周滿	周	滿	謙之
陳乙	陳	乙	子元
謝少南	謝	少南	應午
曾孔化	曾	孔化	宗周
柯實卿	柯	實卿	光仲
趙維	趙	維	張父
高世彥	高	世彥	仲修
魏廷萱	魏	廷萱	子宜
林華	林	華	廷彬
翁學淵	翁	學淵	原道
陳玒	陳	玒	國祥
左鎰	左	鎰	應衡
何其高	何	其高	抑之
楊伊志	楊	伊志	子任
唐國相	唐	國相	舜舉
周宗鎬	周	宗鎬	于京
白恱	白	恱	貞夫
陳叔頣	陳	叔頣	子貞
陳爼	陳	爼	少志
陸期范	陸	期范	任卿
徐禎	徐	禎	世兆
劉璽	劉	璽	國符
蔣信	蔣	信	卿實
茅鎜	茅	鎜	新之
范欽	范	欽	堯卿
張明	張	明	元亮
陳仕賢	陳	仕賢	邦憲
呂懷	呂	懷	汝德
辛童	辛	童	秉忠
劉儒	劉	儒	子醇
范瑟	范	瑟	孔和
錢亮	錢	亮	執夫
張愚	張	愚	子明
黃應中	黃	應中	子孚
許檖	許	檖	國華
吳至	吳	至	道卿
秦鳴夏	秦	鳴夏	子亨
施雨	施	雨	潤之
張謙	張	謙	子益
于廷寅	于	廷寅	貳卿
許應元	許	應元	子春
劉繼祿	劉	繼祿	承德
邉侁	邉	侁	行甫
皇甫涍	皇甫	涍	子安
曾大吉	曾	大吉	子脩
閔如霖	閔	如霖	師望
王椿	王	椿	元齡
董漢儒	董	漢儒	道夫
徐樾	徐	樾	子直
姚翔鳳	姚	翔鳳	夢禎
王珩	王	珩	節甫
毛復	毛	復	世亨
呂瑚	呂	瑚	汝器
趙一中	趙	一中	立夫
雍瀾	雍	瀾	斯道
歐陽清	歐陽	清	懋直
楊成	楊	成	全卿
吳嶽	吳	嶽	汝喬
衛元確	衛	元確	少乾
浦應麒	浦	應麒	道徵
趙伊	趙	伊	子衡
叚承恩	叚	承恩	德夫
游居敬	游	居敬	行簡
韓朂	韓	朂	德懋
陳禎	陳	禎	大和
邵元吉	邵	元吉	惪旋
文衡	文	衡	公孺
余光	余	光	晦之
李延康	李	延康	允吉
潘高	潘	高	子抑
劉澯	劉	澯	汝靜
陳塏	陳	塏	山甫
王廷榦	王	廷榦	維楨
何天啟	何	天啟	義占
鄭吉甫	鄭	吉甫	希憲
王京	王	京	得師
魏尚純	魏	尚純	叔誠
李徵	李	徵	誠之
李乗雲	李	乗雲	子雨
尤魯	尤	魯	懋宗
沈伯咸	沈	伯咸	公甫
曾鈞	曾	鈞	廷和
周鎬	周	鎬	仲京
潘子正	潘	子正	汝中
馮汝弼	馮	汝弼	惟良
曹邁	曹	邁	德仲
張翼翔	張	翼翔	仲羽
葉經	葉	經	叔明
韓威	韓	威	德隅
米榮	米	榮	仁夫
胡鯨	胡	鯨	魚伯
劉汝楠	劉	汝楠	孟材
柳英	柳	英	子鍾
陳策	陳	策	一得
王繼宗	王	繼宗	汝孝
鄭汝舟	鄭	汝舟	宜濟
翟鎬	翟	鎬	周甫
陳脩	陳	脩	宗道
何思	何	思	慎之
王聮	王	聮	應奎
來汝賢	來	汝賢	子禹
周珫	周	珫	潤夫
張世亨	張	世亨	達卿
徐進	徐	進	與可
劉世用	劉	世用	汝賢
党承賜	党	承賜	汝錫
王教	王	教	道脩
常應文	常	應文	汝實
顧存仁	顧	存仁	伯□
林功懋	林	功懋	以謙
賈樞	賈	樞	慎卿
謝庭𦶜	謝	庭𦶜	子佩
黃鵬	黃	鵬	搏之
張棐	張	棐	體周
劉素	劉	素	文之
周卿	周	卿	克果
陳魁	陳	魁	梅甫
陳位	陳	位	汝靖
陳澍	陳	澍	伯雨
殷學	殷	學	成甫
傅頥	傅	頥	觀蒙
俞世潔	俞	世潔	與之
李朝陽	李	朝陽	伯鳴
韓岳	韓	岳	鎮伯
周瑞	周	瑞	循典
趙愈和	趙	愈和	以禮
廖希顏	廖	希顏	叔愚
李愷	李	愷	克諧
吳希孟	吳	希孟	子醇
唐曜	唐	曜	㓜貞
蘇志臯	蘇	志臯	德明
王釴	王	釴	公儀
程秀民	程	秀民	天毓
胡鰲	胡	鰲	巨卿
馬汝彰	馬	汝彰	存美
鄧熺	鄧	熺	世緝
李文鳳	李	文鳳	廷儀
胡魁	胡	魁	應辰
何繼高	何	繼高	思守
陳如綸	陳	如綸	德宣
尹耕	尹	耕	子莘
馮亮	馮	亮	執夫
應鳴鳳	應	鳴鳳	時鳴
朱衡	朱	衡	士南
王惟賢	王	惟賢	士官
錢照	錢	照	叔初
馮應元	馮	應元	體乾
楊登	楊	登	子先
趙民順	趙	民順	敬孺
邢址	邢	址	汝立
洪垣	洪	垣	峻之
黃大廉	黃	大廉	潔甫
李淳	李	淳	文卿
劉天授	劉	天授	可全
扈永通	扈	永通	一貫
張遜	張	遜	士敏
孫繼先	孫	繼先	孝卿
謝瑜	謝	瑜	良卿
呂光洵	呂	光洵	信卿
陳豪	陳	豪	志興
沈越	沈	越	中甫
陳時	陳	時	宜之
謝九儀	謝	九儀	君賜
尹相	尹	相	啇衡
孫簡	孫	簡	維敬
錢嶫	錢	嶫	君望
吳伯亨	吳	伯亨	子貞
吳悌	吳	悌	思誠
何中行	何	中行	粹甫
呂應祥	呂	應祥	子和
劉光文	劉	光文	繼純
包節	包	節	元達
林應亮	林	應亮	熙載
張梯	張	梯	子階
高尚志	高	尚志	德崇
嚴寬	嚴	寬	栗夫
葉國華	葉	國華	尚賔
陳文浩	陳	文浩	子川
徐榮	徐	榮	仁卿
周亮	周	亮	尚寅
宋天民	宋	天民	若尹
曾汝檀	曾	汝檀	惟馨
郭鋆	郭	鋆	允重
杜鍷	杜	鍷	邦平
勞紹科	勞	紹科	獻伯
黃獻可	黃	獻可	尭俞
路天亨	路	天亨	仲元
張光祖	張	光祖	德徵
陶謨	陶	謨	大顯
劉九容	劉	九容	慎卿
賈文元	賈	文元	體仁
盧勳	盧	勳	汝立
王應詔	王	應詔	公舉
趙汝濂	趙	汝濂	敦夫
邉沆	邉	沆	文灝
申用休	申	用休	戒之
薛廷寵	薛	廷寵	汝承
史褒善	史	褒善	文直
唐寬	唐	寬	栗夫
姚虞	姚	虞	宗舜
楊賢	楊	賢	公薦
陳讓	陳	讓	原禮
謝上箴	謝	上箴	以善
朱廷臣	朱	廷臣	敬之
董珆	董	珆	子純
楊鎡	楊	鎡	應時
張壽	張	壽	汝靜
趙允亨	趙	允亨	伯通
陶欽夔	陶	欽夔	伯諧
石永	石	永	壽卿
劉仕賢	劉	仕賢	以道
張珪	張	珪	君如
周南	周	南	道南
王獻芝	王	獻芝	德仁
孫校	孫	校	右文
侯珮	侯	珮	天和
侯度	侯	度	憲甫
董德明	董	德明	汝哲
汪東洋	汪	東洋	德涵
劉訓	劉	訓	子伊
劉士逵	劉	士逵	伯鴻
何元述	何	元述	元孝
胡汝翼	胡	汝翼	伯鄰
黃德純	黃	德純	敬脩
承林	承	林	茂卿
劉思唐	劉	思唐	尚友
沈弘彝	沈	弘彝	君叙
𨶒樸	𨶒	樸	文甫
孫哲	孫	哲	用䀲
胡守中	胡	守中	伯時
田大有	田	大有	豫甫
席大賔	席	大賔	子瞻
李謹	李	謹	常甫
董官	董	官	惟賢
張舜臣	張	舜臣	希臯
胡公廉	胡	公廉	介卿
錢籍	錢	籍	汝載
駱𩦸	駱	𩦸	汝良
鄭普	鄭	普	汝德
李本	李	本	汝立
趙維垣	趙	維垣	伯師
伊敏生	伊	敏生	子蒙
李完	李	完	子美
朱懷幹	朱	懷幹	守正
呂懷健	呂	懷健	思順
陳諫	陳	諫	公從
王繼芳	王	繼芳	世昌
陳時熙	陳	時熙	舜民
王朝賢	王	朝賢	立之
方召南	方	召南	文化
何賛	何	賛	尭卿
朱憲章	朱	憲章	守良
王弘道	王	弘道	士達
楊勉學	楊	勉學	仲潛
范愛	范	愛	體仁
何城	何	城	叔防
冉崇禮	冉	崇禮	季周
徐表	徐	表	正夫
胡明庶	胡	明庶	功甫
楊雷	楊	雷	起潛
王瑛	王	瑛	汝玉
錢薇	錢	薇	懋垣
劉廷範	劉	廷範	汝顏
周采	周	采	子亮
王梴	王	梴	子長
廖天明	廖	天明	敬之
蔡汝楠	蔡	汝楠	子木
張鶚	張	鶚	直夫
潘恕	潘	恕	行之
曹邦輔	曹	邦輔	子忠
朱默	朱	默	時言
羅大用	羅	大用	時行
王梅	王	梅	時魁
王玉汝	王	玉汝	體成
雷禮	雷	禮	必進
張思	張	思	慎父
傅鎮	傅	鎮	國鼎
馬中驥	馬	中驥	惟德
畢烜	畢	烜	彥晦
邉涔	邉	涔	文躍
程珤	程	珤	子彬
樊深	樊	深	希淵
徐守義	徐	守義	子和
夏應元	夏	應元	體仁
李大魁	李	大魁	伯掄
王良柱	王	良柱	全宇
閔旦	閔	旦	景周
陳儲秀	陳	儲秀	舜弼
方任	方	任	志伊
周大禮	周	大禮	子和
周復俊	周	復俊	子籲
郭希顏	郭	希顏	仲愚
錢德洪	錢	德洪	洪甫
王畿	王	畿	汝中
史際	史	際	恭甫
賀恩	賀	恩	君錫
尹宇	尹	宇	光甫
胡岳	胡	岳	宗高
顧翀	顧	翀	于漸
王佩	王	佩	朝鳴
韓應龍	韓	應龍	汝化
孫陞	孫	陞	志高
吳山	吳	山	曰靜
李璣	李	璣	邦在
趙貞吉	趙	貞吉	孟靜
敖銑	敖	銑	純之
郭朴	郭	朴	質夫
任瀛	任	瀛	登之
沈宏	沈	宏	惟遠
駱文盛	駱	文盛	質甫
尹臺	尹	臺	崇基
康大和	康	大和	原中
李學顏	李	學顏	幼潛
許榖	許	榖	仲貽
鄭質夫	鄭	質夫	子質
趙希蘷	趙	希蘷	一卿
高燿	高	燿	子潛
馬從謙	馬	從謙	益之
沈瀚	沈	瀚	原約
艾希淳	艾	希淳	治伯
沈應龍	沈	應龍	翔卿
錢衝	錢	衝	貴徐
張標	張	標	汝式
方民悅	方	民悅	懋德
譙孟龍	譙	孟龍	乾甫
劉澍	劉	澍	汝霖
歐陽日奐	歐陽	日奐	學章
許登瀛	許	登瀛	預甫
黃宗器	黃	宗器	時震
姚文祜	姚	文祜	申甫
彭大有	彭	大有	子謙
公躋奎	公	躋奎	瑞文
陳崇慶	陳	崇慶	懋貞
舒纓	舒	纓	振伯
范慶	范	慶	元會
劉輔	劉	輔	少鄰
鄒絢	鄒	絢	原素
李蓁	李	蓁	懋承
王崇	王	崇	子謙
王珉	王	珉	玉中
王立道	王	立道	懋中
陳堯	陳	堯	敬甫
嵇世臣	嵇	世臣	思用
楊一謨	楊	一謨	世文
王儒	王	儒	聘卿
林廷琛	林	廷琛	世獻
王朝相	王	朝相	志尹
劉注東	劉	注東	思禹
敖璠	敖	璠	貴之
張天麟	張	天麟	允禎
呂韶	呂	韶	鳳儀
李時達	李	時達	中夫
李增	李	增	孟川
曹一貫	曹	一貫	唯夫
彭鳳	彭	鳳	起之
萬汝楫	萬	汝楫	濟卿
李樂	李	樂	和仲
謝佑	謝	佑	德夫
鄭鑒	鄭	鑒	允明
孫植	孫	植	斯立
張瀚	張	瀚	子文
李載贄	李	載贄	進可
竇潤	竇	潤	子雨
鄭一統	鄭	一統	朝慶
陳元珂	陳	元珂	仲聲
陳樁	陳	樁	子年
薛孟	薛	孟	惟亞
許復禮	許	復禮	仁甫
翁璨	翁	璨	德輝
江中躍	江	中躍	從之
袁襲裳	袁	襲裳	子宜
易寬	易	寬	栗夫
趙憲	趙	憲	子成
方孟縉	方	孟縉	文卿
沈夢鯉	沈	夢鯉	龍卿
姚良弼	姚	良弼	夢賢
陳天然	陳	天然	汝中
劉佐	劉	佐	才甫
施千祥	施	千祥	善徵
周世昭	周	世昭	景服
陳天資	陳	天資	汝學
蕭體元	蕭	體元	善復
宋淳	宋	淳	德完
蒲澤	蒲	澤	仁伯
黃雲	黃	雲	叔卿
戴執魚	戴	執魚	時化
劉棟	劉	棟	曰隆
曹嗣榮	曹	嗣榮	繩之
康明	康	明	用晦
胡汝霖	胡	汝霖	仲望
諸燮	諸	燮	子相
馬承學	馬	承學	弘道
吳藩	吳	藩	价甫
吳九經	吳	九經	子誠
許福	許	福	堯錫
周天佐	周	天佐	宇弼
施峻	施	峻	平叔
李維藩	李	維藩	子价
馮天馭	馮	天馭	應房
毛概	毛	概	世節
章甫	章	甫	夢甫
顧廉	顧	廉	惟簡
林庭機	林	庭機	利仁
趙崇信	趙	崇信	仲履
劉尚義	劉	尚義	伯正
唐頤	唐	頤	子觀
王達	王	達	子泉
邵南	邵	南	文化
來聘	來	聘	安國
何彥	何	彥	善充
舒汀	舒	汀	紹安
楊守約	楊	守約	允中
范之箴	范	之箴	從敬
高時	高	時	中行
陳紹	陳	紹	用光
趙大佑	趙	大佑	世胤
蔡其潮	蔡	其潮	時信
趙應祥	趙	應祥	伯徵
李夢祥	李	夢祥	初徵
錢應揚	錢	應揚	俊民
黃廷用	黃	廷用	汝行
焦璉	焦	璉	子重
奚良輔	奚	良輔	世卿
徐緝	徐	緝	文熙
楊上林	楊	上林	子漸
王遵	王	遵	子法
汪集	汪	集	惟義
溫學舜	溫	學舜	憲統
羅椿枝	羅	椿枝	日新
王崇冠	王	崇冠	雅夫
薛應旂	薛	應旂	仲常
周尚忠	周	尚忠	伯顯
顧承芳	顧	承芳	子譽
盧璘	盧	璘	秀夫
鮑龍	鮑	龍	汝化
馬九德	馬	九德	子懋
楊時秀	楊	時秀	叔茂
張舜臣	張	舜臣	熙伯
吳鏌	吳	鏌	利用
戴夢桂	戴	夢桂	仲芳
劉大直	劉	大直	養浩
郭鎜	郭	鎜	允新
胡崇德	胡	崇德	伯賢
翁五倫	翁	五倫	大經
黎堯勳	黎	堯勳	子欽
高崶	高	崶	仲龍
余爌	余	爌	德明
陳鳳	陳	鳳	羽伯
閔煦	閔	煦	和卿
李丕顯	李	丕顯	憲文
傅珮	傅	珮	朝鳴
謝鎰	謝	鎰	萬卿
沈良才	沈	良才	德夫
張維岳	張	維岳	堯臣
吳應奎	吳	應奎	汝文
葉懋賞	葉	懋賞	功父
谷宇齡	谷	宇齡	道延
朱文質	朱	文質	彬甫
趙統	趙	統	伯一
陳東光	陳	東光	叔晦
顧霑	顧	霑	少雨
黎秀	黎	秀	實甫
張堯年	張	堯年	紹中
童漢臣	童	漢臣	仲良
鄭芸	鄭	芸	士馨
林應麒	林	應麒	必仁
趙繼孟	趙	繼孟	宗之
孫昺	孫	昺	尚晦
何允魁	何	允魁	克升
陳瑚	陳	瑚	汝器
蕭祥曜	蕭	祥曜	文奎
吳從義	吳	從義	思忠
向宗哲	向	宗哲	汝賢
張祜	張	祜	元秩
楊祜	楊	祜	受夫
陸坤	陸	坤	子厚
任道充	任	道充	少虛
馮良知	馮	良知	養吾
艾朴	艾	朴	子文
王燁	王	燁	韜孟
李人龍	李	人龍	子乾
鄭錫麟	鄭	錫麟	獻禎
錢冸	錢	冸	鳴教
高節	高	節	仲立
牟朝宗	牟	朝宗	子一
邵基	邵	基	子原
王嘉元	王	嘉元	仁仲
李檗	李	檗	時勵
聶靜	聶	靜	子安
王世雍	王	世雍	堯治
劉鳳池	劉	鳳池	文甫
吳瓊	吳	瓊	德輝
趙炳然	趙	炳然	子晦
許貫之	許	貫之	道卿
王喬齡	王	喬齡	維岳
汪宗凱	汪	宗凱	子才
包孝	包	孝	元愛
張輻	張	輻	文衡
曹韓	曹	韓	可宗
鄭寅	鄭	寅	思敬
王維楨	王	維楨	允寧
張緒	張	緒	卿理
王之臣	王	之臣	敬充
王鏜	王	鏜	孟聲
牛斗	牛	斗	雲章
徐方	徐	方	來夫
昝如思	昝	如思	子學
吳轅	吳	轅	子庸
薛騰蛟	薛	騰蛟	時化
錢邦彥	錢	邦彥	治徵
汪旦	汪	旦	昭仲
王夢弼	王	夢弼	惟肖
黃齊賢	黃	齊賢	汝思
楊獎	楊	獎	懋德
葛縉	葛	縉	仲榮
江應選	江	應選	尚賓
劉汀	劉	汀	叔南
李愈	李	愈	惟中
饒相	饒	相	志尹
王光宇	王	光宇	伯潛
周鳳岐	周	鳳岐	文徵
方介	方	介	子和
楊萬程	楊	萬程	志搏
沈民悅	沈	民悅	惟公
楊子臣	楊	子臣	維人
王三接	王	三接	汝康
蔡大用	蔡	大用	道行
張良貴	張	良貴	子元
毛愷	毛	愷	達和
李秦	李	秦	仲西
宿椿	宿	椿	孔齡
蘇應旻	蘇	應旻	幼清
陳暹	陳	暹	德輝
舒遷	舒	遷	于喬
姚潓	姚	潓	維順
李念	李	念	惟克
俞則全	俞	則全	祖修
趙弘	趙	弘	鳴重
梁格	梁	格	君正
沈垣	沈	垣	子完
謝袞	謝	袞	公補
任萬里	任	萬里	圖南
陳策	陳	策	時偕
陳士儀	陳	士儀	德隅
李文進	李	文進	先之
沈鎜	沈	鎜	大新
吳性	吳	性	定甫
吳璁	吳	璁	世振
王應期	王	應期	伯起
陳棐	陳	棐	汝忠
張永明	張	永明	鍾誠
徐祚	徐	祚	子厚
李東光	李	東光	晉卿
陸子明	陸	子明	東卿
章檗	章	檗	貞叔
傅應詔	傅	應詔	起巖
龍遂	龍	遂	良卿
吳嘉會	吳	嘉會	惟禮
張元	張	元	以貞
魏希佐	魏	希佐	以道
王希賢	王	希賢	行復
陳中	陳	中	時仲
廖世魁	廖	世魁	師文
胡叔元	胡	叔元	允卿
黃文炳	黃	文炳	以約
李世芳	李	世芳	伯傳
張纓	張	纓	重卿
李秉仁	李	秉仁	子元
鄭有周	鄭	有周	郁之
何維栢	何	維栢	喬仲
魏良貴	魏	良貴	師孟
李登雲	李	登雲	子漸
郭廷冕	郭	廷冕	季文
饒天民	饒	天民	明先
盧宗哲	盧	宗哲	濬卿
胡植	胡	植	立之
陳邦脩	陳	邦脩	德卿
安宅	安	宅	子仁
梅凌雲	梅	凌雲	尚志
張玭	張	玭	席王
靳學顏	靳	學顏	子愚
周浩	周	浩	允集
林庭壆	林	庭壆	利節
張旦	張	旦	子明
鄭富	鄭	富	中虛
金元立	金	元立	汝禮
陳與音	陳	與音	汝和
藍濟卿	藍	濟卿	用楫
鄭烱	鄭	烱	章甫
徐守道	徐	守道	子中
徐桂	徐	桂	子芳
趙繼本	趙	繼本	孝甫
高捷	高	捷	漸卿
朱尚質	朱	尚質	宗商
彭相	彭	相	良仲
李天然	李	天然	一中
楊應奇	楊	應奇	時望
王三聘	王	三聘	夢莘
李文昇	李	文昇	子蔚
牛恒	牛	恒	子占
張拱文	張	拱文	獻仁
李壂	李	壂	樨安
郭朝賓	郭	朝賓	尚甫
翁世經	翁	世經	可貞
許天倫	許	天倫	汝明
車邦佑	車	邦佑	翊卿
盧楩	盧	楩	木伯
劉繪	劉	繪	少質
張珍	張	珍	聘之
王一言	王	一言	行恕
崔官	崔	官	懋德
李兆龍	李	兆龍	孺徵
舒鵬翼	舒	鵬翼	于南
胡賓	胡	賓	汝觀
馬森	馬	森	孔養
周岱	周	岱	汝鎮
郭萬程	郭	萬程	子長
錢萱	錢	萱	懋孝
盧孝達	盧	孝達	維周
陳雲衢	陳	雲衢	邦英
曹亨	曹	亨	伯貞
劉永	劉	永	吉甫
孫國	孫	國	道甫
洗桂奇	洗	桂奇	奕倩
黃鰲	黃	鰲	時鎮
茅瓚	茅	瓚	邦獻
羅珵	羅	珵	邦珍
袁煒	袁	煒	懋中
張惟一	張	惟一	守中
朱應雲	朱	應雲	從龍
吳源	吳	源	宗乾
莫如忠	莫	如忠	子良
陸師道	陸	師道	子傳
倫以詵	倫	以詵	彥群
方國佐	方	國佐	君英
喬世寧	喬	世寧	景叔
馬拯	馬	拯	壯宇
吳舂	吳	舂	以容
吳崑	吳	崑	美之
姚璋	姚	璋	汝玉
沈奎	沈	奎	文明
楊濂	楊	濂	伯清
董子儀	董	子儀	羽吉
王健	王	健	偉純
丁以忠	丁	以忠	崇義
王問	王	問	子裕
郭乾	郭	乾	易甫
朱用	朱	用	伯際
唐穆	唐	穆	景文
劉廷臣	劉	廷臣	伯鄰
燕楫	燕	楫	廷濟
陳憲	陳	憲	道夫
陳昌積	陳	昌積	子發
謝淮	謝	淮	禹匯
侯汝諒	侯	汝諒	叔貞
翁大立	翁	大立	孺參
汪俅	汪	俅	克敬
林懋植	林	懋植	君本
萬敏	萬	敏	欽夫
楊金	楊	金	重南
盧壁	盧	壁	國賢
沈𡹘	沈	𡹘	子由
洪世文	洪	世文	國華
侯一元	侯	一元	舜舉
畢竟容	畢	竟容	仁叔
白若圭	白	若圭	德純
吳元璧	吳	元璧	君錫
聞人悳行	聞	人悳行	元科
俞憲	俞	憲	汝成
張鎬	張	鎬	啟周
周鯤	周	鯤	少魚
王輪	王	輪	子庸
黃懋官	黃	懋官	君辨
葉選	葉	選	仁夫
張朝聘	張	朝聘	伯時
李憲卿	李	憲卿	廉夫
李廷春	李	廷春	懋仁
嚴中	嚴	中	執甫
孫璧	孫	璧	文甫
陳鎏	陳	鎏	子兼
譚維	譚	維	元立
王楠	王	楠	惟喬
劉志	劉	志	寧卿
徐緯	徐	緯	文成
鄭廷鵠	鄭	廷鵠	元侍
章煥	章	煥	懋實
蔣懷德	蔣	懷德	維寧
卿文瑞	卿	文瑞	孺賢
俞維屏	俞	維屏	樹德
彭希賢	彭	希賢	及夫
陳敘	陳	敘	邦禮
周南	周	南	文化
張敦仁	張	敦仁	仲安
馮煥	馮	煥	養晦
南逢吉	南	逢吉	元貞
呂顒	呂	顒	幼誠
辛烜然	辛	烜然	養晦
徐楚	徐	楚	世望
蔣坎	蔣	坎	養孚
趙同言	趙	同言	德孚
姚汝舟	姚	汝舟	濟卿
盛若林	盛	若林	子才
翁相	翁	相	長卿
唐臣	唐	臣	止敬
李繼先	李	繼先	伯孝
陳穆	陳	穆	舜賓
王時儉	王	時儉	本節
陳紹儒	陳	紹儒	師孔
張渙	張	渙	文甫
盧夢陽	盧	夢陽	少明
錢芹	錢	芹	懋文
郭紘	郭	紘	伯瞻
李寵	李	寵	汝承
戴楩	戴	楩	汝材
黃九皐	黃	九皐	汝鳴
孫銓	孫	銓	文揆
張祉	張	祉	子受
李棠	李	棠	叔思
王嘉謨	王	嘉謨	仲陳
沈友儒	沈	友儒	子真
李時春	李	時春	一元
周建邦	周	建邦	維新
張濂	張	濂	子清
劉洵	劉	洵	睿甫
張元冲	張	元冲	叔謙
裴紳	裴	紳	子書
江鯤	江	鯤	子鵬
陳光哲	陳	光哲	子愚
齊譽	齊	譽	文實
張景賢	張	景賢	勉之
李綸	李	綸	德言
潘釴	潘	釴	希行
陳淮	陳	淮	東之
厲汝進	厲	汝進	子脩
劉廷誥	劉	廷誥	汝欽
任良	任	良	康孟
張松	張	松	汝喬
李棟	李	棟	隆仲
馮炫	馮	炫	體謙
朱執中	朱	執中	汝一
王士翹	王	士翹	民瞻
顏嘉會	顏	嘉會	子亨
施諲	施	諲	敬叔
鮑龍	鮑	龍	時化
魏尚綸	魏	尚綸	仲一
汪伊	汪	伊	汝衡
薛尚義	薛	尚義	仲行
林萬潮	林	萬潮	養晦
陳宗夔	陳	宗夔	維一
步允遷	步	允遷	子安
楊以誠	楊	以誠	明夫
敖宗慶	敖	宗慶	汝承
卜大同	卜	大同	吉夫
賈大亨	賈	大亨	貞甫
張汝棟	張	汝棟	伯隆
周怡	周	怡	順之
趙正學	趙	正學	子崇
高節	高	節	爾瞻
黃注	黃	注	汝霖
楊九澤	楊	九澤	子德
劉廷儀	劉	廷儀	汝修
張煌	張	煌	用韜
趙汴	趙	汴	伯京
李希程	李	希程	宗伊
胡叔廉	胡	叔廉	明發
王之臣	王	之臣	原孝
孫宏軾	孫	宏軾	以瞻
譚棨	譚	棨	朝器
林應箕	林	應箕	輝南
臧珊	臧	珊	子珮
韓一右	韓	一右	汝弼
劉養直	劉	養直	敬夫
馮時雨	馮	時雨	慰民
李廷松	李	廷松	茂貞
諸葛峴	諸葛	峴	叔靜
馬麟	馬	麟	子振
吳寵	吳	寵	俊卿
劉維禴	劉	維禴	子孚
喻時	喻	時	中甫
曹守貞	曹	守貞	子一
喻希學	喻	希學	博之
顧問	顧	問	子承
王春復	王	春復	學收
王炯	王	炯	幼明
孫喬	孫	喬	世南
李孔陽	李	孔陽	子朱
劉昭文	劉	昭文	汝簡
金城	金	城	邦衛
馮惟重	馮	惟重	汝威
程軏	程	軏	信甫
王國楨	王	國楨	以寧
李天寵	李	天寵	子承
劉三畏	劉	三畏	少欽
孫文錫	孫	文錫	公爵
鄭一鸞	鄭	一鸞	鳴陽
郭進	郭	進	抑之
趙承謙	趙	承謙	德光
朱尚文	朱	尚文	質卿
蔣宗魯	蔣	宗魯	道父
李和芳	李	和芳	仁父
朱徵	朱	徵	晉卿
黃宗槩	黃	宗槩	時節
齊宗道	齊	宗道	叔魯
張道	張	道	允中
鄒守	鄒	守	惟一
程紳	程	紳	伯書
林冕	林	冕	端吾
張瑞	張	瑞	應時
繆文龍	繆	文龍	惟德
葛廷章	葛	廷章	朝憲
李凌雲	李	凌雲	子鵬
鄭光溥	鄭	光溥	伯公
劉學易	劉	學易	道甫
趙恒	趙	恒	志貞
李珊	李	珊	敬孚
朱家相	朱	家相	伯鄰
黃洪毗	黃	洪毗	協恭
周寧	周	寧	彥靖
胡經	胡	經	伯常
林策	林	策	直夫
孫孟	孫	孟	端甫
李用和	李	用和	元樂
戴維師	戴	維師	秉文
吳相	吳	相	汝立
楊梁	楊	梁	廷材
劉起宗	劉	起宗	宗之
張思誠	張	思誠	子脩
何御	何	御	範之
孟淮	孟	淮	豫川
張僖	張	僖	廷和
鮑道明	鮑	道明	行之　
葉遇春	葉	遇春	體仁
劉大武	劉	大武	象成
程時思	程	時思	以學
董子策	董	子策	元正
葉照	葉	照	以明
葉春澤	葉	春澤	仁敷
許元祥	許	元祥	國鍾
聶櫟	聶	櫟	公壽
劉洛生	劉	洛生	希程
劉大實	劉	大實	子虛
陳鵠	陳	鵠	鳴霄
張秉壺	張	秉壺	國鎮
張文卿	張	文卿	質夫
胡川楫	胡	川楫	巨卿　
袁鳳鳴	袁	鳳鳴	子時
吳蘭	吳	蘭	卿佩
蒿賓	蒿	賓	大賓
徐良傅	徐	良傅	子弼
歐陽建	歐陽	建	參可
洪庭桂	洪	庭桂	德馨
胡堯臣	胡	堯臣	伯純
董懋中	董	懋中	德甫
郭惟清	郭	惟清	寅仲
倪瑗	倪	瑗	公引　
袁袞	袁	袞	補之
莊思寬	莊	思寬	君栗　
孟顏	孟	顏	學顏
劉乾	劉	乾	仲坤
趙之屏	趙	之屏	憲甫
甄成德	甄	成德	行叔
冷珂	冷	珂	鳴叔
孟廷相	孟	廷相	爰立
劉選	劉	選	子銓
王尚學	王	尚學	敏叔　
王德	王	德	汝脩
謝體升	謝	體升	順之
唐時	唐	時	學孔　
魏謙吉	魏	謙吉	子惠
張情	張	情	約之
劉燾	劉	燾	仁甫
查秉彝	查	秉彝	性甫
吳世良	吳	世良	元良
張詔	張	詔	朝宣
丘玳	丘	玳	文玉
李實	李	實	幼華
許瑄	許	瑄	伯溫
張潛	張	潛	時見
黃如桂	黃	如桂	德馨
蕭世延	蕭	世延	可靜
羅廷繡	羅	廷繡	公裳
金志	金	志	允立
余善繼	余	善繼	伯賢
吳道南	吳	道南	文在
楊載鳴	楊	載鳴	虛卿
沈鍊	沈	鍊	純甫
李一瀚	李	一瀚	源甫
洪恩	洪	恩	從仁
符驗	符	驗	大克
高謙	高	謙	孔益
汝齊賢	汝	齊賢	懋思
吳維嶽	吳	維嶽	峻伯
萬虞愷	萬	虞愷	懋卿
茅坤	茅	坤	順甫
汪宗伊	汪	宗伊	子衡
馮璋	馮	璋	如之
林紳	林	紳	佩之
順境	順	境	履常
李槃	李	槃	新甫
李嵩	李	嵩	中行
劉存德	劉	存德	志仁
阮高	阮	高	思抑
游震得	游	震得	汝潛
杜汝楨	杜	汝楨	公寧　
盛唐	盛	唐	原陶
李遇春	李	遇春	時芳
鄭直	鄭	直	子敬
坑進良	坑	進良	汝率
馮惟訥	馮	惟訥	汝言
許東望	許	東望	應魯
胡宗憲	胡	宗憲	汝欽
蕭軾	蕭	軾	仲敬
諸敬之	諸	敬之	守禮
譚大初	譚	大初	宗元
徐鶴齡	徐	鶴齡	仁甫
萬文彩	萬	文彩	國華
邵楩	邵	楩	良用
李僅可	李	僅可	子與
羅崇奎	羅	崇奎	子文
陳珂	陳	珂	仲聲
孟養性	孟	養性	存甫　
阮朝策	阮	朝策	子定
周山	周	山	子仁
張雨	張	雨	惟時
歐思賢	歐	思賢	希甫
楊皆	楊	皆	同鄉
荊應春	荊	應春	子元
李寵	李	寵	元勳
王堯日	王	堯日	明時
魏夢賢	魏	夢賢	良輔
谷嶠	谷	嶠	惟升
溫新	溫	新	伯明
張玶	張	玶	子珍
朱鵠	朱	鵠	秉直
尹綸	尹	綸	汝漁
林大有	林	大有	端時
王崇義	王	崇義	子由
汪栢	汪	栢	廷節
王大平	王	大平	象行
陳應魁	陳	應魁	孚元
杜拯	杜	拯	子民
王心	王	心	惟一
徐文亨	徐	文亨	道行
牛沈度	牛	沈度	玄範　
宋惟元	宋	惟元	以貞
沈坤	沈	坤	伯載
潘晟	潘	晟	思明
林一鳳	林	一鳳	伯羽
高儀	高	儀	子象
董份	董	份	用均
陳陞	陳	陞	晉甫
林樹聲	林	樹聲	與吉
潘仲驂 	潘	仲驂 	時乘
謝東山	謝	東山	少安
朱凌	朱	凌	原沖
嚴訥	嚴	訥	敏卿
徐養正	徐	養正	吉夫
楊謨	楊	謨	汝承
趙大綱	趙	大綱	萬舉
高拱	高	拱	肅卿
宋大武	宋	大武	文成
賈鶴年	賈	鶴年	惟仁
葉鏜	葉	鏜	汝聲
吳三樂	吳	三樂	子有
萬士亨	萬	士亨	思通
張鶚	張	鶚	一卿
張子瑫	張	子瑫	仲玉
孫續	孫	續	道父
呂時中	呂	時中	道夫
杜秉彛	杜	秉彛	性之
何雲鴈	何	雲鴈	時賓
洪朝選 	洪	朝選 	舜臣
戴章甫	戴	章甫	元禮
謝廷試	謝	廷試	汝明
曹忭	曹	忭	子誠
楊周	楊	周	道甫
范惟一	范	惟一	于中
趙文燿	趙	文燿	絅夫
張希舉	張	希舉	直卿
張斗寅	張	斗寅	子人
周土	周	土	厚卿
全賜	全	賜	厚甫
尹祖懋	尹	祖懋	德卿
劉夢元	劉	夢元	伯始
方治	方	治	進卿
陰標	陰	標	時準
畢竟夔	畢	竟夔	叔元
陸杲	陸	杲	元晉
羅衣	羅	衣	章甫
沈橋	沈	橋	宗周
黎材	黎	材	用卿
董策	董	策	希舒
王景象	王	景象	啟明
章美中	章	美中	積之
徐一鳴	徐	一鳴	原默
張緯	張	緯	朝文　
王重光	王	重光	廷宣
夏子開	夏	子開	本初
曾于拱	曾	于拱	思極
周鎬	周	鎬	元化
黃深	黃	深	舜功
費滂	費	滂	子雨
齊準	齊	準	平甫
弋中和	弋	中和	道夫
陳洪範	陳	洪範	錫卿
萬士和	萬	士和	思節
林大章	林	大章	章之
陳時範	陳	時範	敷疇
陳洪濛	陳	洪濛	元卿
李泂	李	泂	伯遠
王言	王	言	大行
殷邁	殷	邁	時訓
王正容	王	正容	德輝
謝國賓	謝	國賓	思敬
黃顯	黃	顯	仁叔
李遷	李	遷	子安
張鶚翼	張	鶚翼	習之
尹燾	尹	燾	明溥
金翮	金	翮	思振
徐南金	徐	南金	體乾
梁津	梁	津	濟卿
陳善	陳	善	繼初
吳天壽	吳	天壽	平甫
劉鑑	劉	鑑	汝照
齊傑	齊	傑	士庸
朱乾亨	朱	乾亨	子貞
李台	李	台	星伯
王覺	王	覺	士先
章煥	章	煥	叔晦
張洽	張	洽	子德
陶大年	陶	大年	長卿
董士弘	董	士弘	體仁
王撫民	王	撫民	仁甫
徐綱	徐	綱	振之
王崇古	王	崇古	學甫
侯鉞	侯	鉞	義甫
陳梧	陳	梧	思植
朱惟一	朱	惟一	吉夫
周嶅	周	嶅	景魯
王養浩	王	養浩	伯充
陳王道	陳	王道	子敬
周冕	周	冕	叔敬
唐志大	唐	志大	子迪
劉瑤	劉	瑤	潤夫
何良傅	何	良傅	叔皮
路可由	路	可由	子正
鄢懋卿	鄢	懋卿	景修
李時濟	李	時濟	伯舟
陳松	陳	松	子喬
陳鑨	陳	鑨	世嘉
黃應策	黃	應策	君用
白璧	白	璧	石仲
楊思忠	楊	思忠	孝夫
王學柳	王	學柳	宗文
翟澄	翟	澄	憲清
趙紳	趙	紳	子縉
龔秉德	龔	秉德	性之
崔一濂	崔	一濂	學周
王崇儉	王	崇儉	叔度
王顯忠	王	顯忠	元孝
梁汝璧	梁	汝璧	應文　
馬鍾英　	馬	鍾英　	君儲
李豸	李	豸	直卿
李時行	李	時行	少偕
徐履祥	徐	履祥	子旋
陳其樂	陳	其樂	惟和
華舜欽	華	舜欽	叔俞
朱瑞登	朱	瑞登	禾仲
方逢時	方	逢時	兆行
尚維持	尚	維持	國相
吳必孝	吳	必孝	純卿
徐亮	徐	亮	子寅
蕭端蒙	蕭	端蒙	曰啟
馮元	馮	元	大本
邢尚簡	邢	尚簡	原敬
周希程	周	希程	道夫
羅時霖	羅	時霖	汝濟
曾佩	曾	佩	德夫
陳九德	陳	九德	吉夫
吳崇文　	吳	崇文　	質夫
王忬	王	忬	民應
李庶	李	庶	季卿
郝良臣	郝	良臣	廷藎
鈕緯	鈕	緯	仲文
楊順	楊	順	子備
張牧	張	牧	舜臣
杜璁	杜	璁	玉仲
曾茂卿	曾	茂卿	時育
張祥	張	祥	元吉
陸美中	陸	美中	汝文
余夢說	余	夢說	商卿
馮薦	馮	薦	伯受
莫如爵	莫	如爵	子脩
金世龍	金	世龍	孟陽
林議	林	議	邦直
郭大鯤	郭	大鯤	時化
姚梧	姚	梧	文陽
陸鑑	陸	鑑	子明
宋大勺	宋	大勺	道成
冷起元	冷	起元	繼貞
浦之浩　	浦	之浩　	子化
張科	張	科	子漸
李仰止	李	仰止	君山
雷逵	雷	逵	時漸
雷賀	雷	賀	時雍
聞賢	聞	賢	國賓
魏希相	魏	希相	漢卿
張重	張	重	汝任
李長盛	李	長盛	宗裕　
林松	林	松	喬年
何派行	何	派行	應克
彭謹	彭	謹	德全
潘璵	潘	璵	魯珍
劉子興	劉	子興	賓之
陳采	陳	采	懋載
楊宗氣	楊	宗氣	子正
宋伊	宋	伊	汝任
阮垕	阮	垕	德載
陳宗仁	陳	宗仁	仲居
金蕃	金	蕃	世宣
胡彥	胡	彥	穉美
王繼洛	王	繼洛	希程
徐岱	徐	岱	太丘
宋治	宋	治	時雍
王三聘	王	三聘	伯衡
蔣珊	蔣	珊	叔珍
楊胤賢	楊	胤賢	子容
王霽	王	霽	汝明
方大樂	方	大樂	憲夔
朱舜民	朱	舜民	虞甫
許鑰	許	鑰	準卿
晁瑮	晁	瑮	君石
姜博	姜	博	約甫
曹天憲	曹	天憲	恒卿
舒載道	舒	載道	以文
黃縉	黃	縉	公華
陳善	陳	善	思敬
陳時霖	陳	時霖	商卿
馮守	馮	守	仁仲
李繼宗	李	繼宗	克承
何光裕	何	光裕	思問
陳以勤	陳	以勤	逸父
張洽	張	洽	文德
王惟中	王	惟中	道原
路伯鏜	路	伯鏜	元振
梅守德	梅	守德	純甫
徐霈	徐	霈	孔霖
鄭維誠	鄭	維誠	伯明
馮綬	馮	綬	以著
趙介夫	趙	介夫	士節
尹梁	尹	梁	子充
林懋和	林	懋和	惟介
李楫	李	楫	濟川
王應鐘	王	應鐘	懋復
謝應徵	謝	應徵	徵夢
梁紹儒	梁	紹儒	存業
黃封	黃	封	伯勳
張登高　	張	登高　	子升
郭維寧	郭	維寧	公懷
霍薰	霍	薰	虞南
趙忻	趙	忻	子樂
王嵩	王	嵩	維中
許嗣宗	許	嗣宗	紹德
陳炌	陳	炌	文晦
張英	張	英	彥實
徐自得	徐	自得	深父
劉九章	劉	九章	公儀
裴宇	裴	宇	子大
陳吉　	陳	吉　	子元
王材	王	材	子難
袁祖庚	袁	祖庚	繩之
李用敬	李	用敬	仲學
黃養蒙	黃	養蒙	存一
劉宦	劉	宦	士晉
周易	周	易	祖羲
鄧巍	鄧	巍	惟成
王交	王	交	徵久
周大有 	周	大有 	元亨
陸從大	陸	從大	履貞
李畫	李	畫	元素
周俶	周	俶	初卿
史載德	史	載德	惟一
李鸞	李	鸞	鳴國
崔峩	崔	峩	汝瞻
熊彥臣	熊	彥臣	元直
彭世爵	彭	世爵	懋賢
董威	董	威	重夫
俞鸞 	俞	鸞 	應和
陳志	陳	志	惟學
張淑勵	張	淑勵	自勉
許廷用	許	廷用	惟範
喻希立	喻	希立	惟中
孫士儀	孫	士儀	文範
唐愛 	唐	愛 	良德
鄭邦仰	鄭	邦仰	思賢
王俸	王	俸	守道
張鐸	張	鐸	世鳴
陳墀	陳	墀	宣甫
王嘉孝	王	嘉孝	體曾
梁木	梁	木	仁夫
劉應熊	劉	應熊	體陽
周俊民	周	俊民	明甫
吳俊	吳	俊	伯英
郭廷序	郭	廷序	循夫
張文愚	張	文愚	維學
盛汝謙	盛	汝謙	亨甫
龔雲從	龔	雲從	時際
戴仁	戴	仁	行父
程良	程	良	明輔
胡慥	胡	慥	敬夫
劉元凱	劉	元凱	舜舉
徐紳	徐	紳	思行
吳禎	吳	禎	元吉
華雲	華	雲	從龍
楊挺高	楊	挺高	叔謙
王曰然	王	曰然	汝從
宋岳	宋	岳	伯鎮
孫渭 	孫	渭 	應清
貴仁	貴	仁	子任
應雲鸑	應	雲鸑	瑞伯
周奎	周	奎	賢象
張習	張	習	子翀
潘繼光	潘	繼光	懋學
劉逢愷	劉	逢愷	虞讓
梁成	梁	成	公濟
高冕	高	冕	服周
劉璧	劉	璧	朝完
馬珮	馬	珮	服玉
陳玉	陳	玉	汝良
于德昌	于	德昌	子順
朱應奎	朱	應奎	士徵
谷鍾秀	谷	鍾秀	毓卿
趙珆 	趙	珆 	子獻
何遷	何	遷	懋益
汪來	汪	來	伯陽
段鍊	段	鍊	文純
徐貢元	徐	貢元	孔賜
馬慎	馬	慎	自脩
吳守貞	吳	守貞	夫定
秦鳴雷	秦	鳴雷	子豫
瞿景淳	瞿	景淳	師道
吳情	吳	情	以中
涂鉉	涂	鉉	廷舉
熊逵 	熊	逵 	于漸
戴完	戴	完	仲修
林洙	林	洙	孔源
劉慤 	劉	慤 	致卿
蔣賓	蔣	賓	汝觀
章士元	章	士元	伯允
李懿	李	懿	美卿
周士佐	周	士佐	汝良
劉松	劉	松	汝貞
王之臣	王	之臣	惟忠
陳天祐	陳	天祐	謙甫
許應亨	許	應亨	子嘉
謝彬 	謝	彬 	文華
許用中	許	用中	子執
阮鶚	阮	鶚	應薦
陳臯謨	陳	臯謨	思贊
雷夢麟	雷	夢麟	伯仁
汪垍	汪	垍	仲弘
吳桂芳	吳	桂芳	子實
李遜	李	遜	子益
查懋昌	查	懋昌	允言
羅一鸑	羅	一鸑	應周
余一鵬	余	一鵬	朝舉
劉光濟	劉	光濟	憲謙
馮有年	馮	有年	子占
徐惟賢	徐	惟賢	師聖
王宗堯 	王	宗堯 	見甫
 馮熊	 	馮熊	伯祥
季德甫	季	德甫	仲修
戈九章	戈	九章	惟衷
劉崙	劉	崙	山甫
林愛民	林	愛民	惟政
曾楚	曾	楚	維翹
謝孟金	謝	孟金	子純
方瑜	方	瑜	元忠
洪公諧	洪	公諧	廷和
張燭	張	燭	汝玉
江冕	江	冕	端甫
陶大有	陶	大有	子謙
陸煒	陸	煒	文蔚
于錦	于	錦	實甫
王宗沐	王	宗沐	新甫
徐文通	徐	文通	汝思
馮覲	馮	覲	晉叔
李宜春	李	宜春	應元
皇甫濂	皇甫	濂	道隆
徐學詩	徐	學詩	以言
李橋	李	橋	文濟
錢嘉猷	錢	嘉猷	敬承
陸穩	陸	穩	汝成
趙釴	趙	釴	子舉
周冉	周	冉	子雲
張仲	張	仲	明孝
萬恭	萬	恭	肅卿
唐禹	唐	禹	思平
胡安	胡	安	仁夫
林光祖	林	光祖	以謙
張子弘	張	子弘	汝容
王詢	王	詢	可庸
舒春芳	舒	春芳	景仁
劉佃	劉	佃	仲有
張大中	張	大中	子用
鄧向榮	鄧	向榮	元植
方九敍	方	九敍	禹績
譚綸	譚	綸	子理
袁福徵	袁	福徵	履善
陸夢豹	陸	夢豹	文蔚
周鍵	周	鍵	啟夫
周爻	周	爻	易夫
余文獻	余	文獻	伯初
項守禮	項	守禮	進伯
王會	王	會	子嘉
蔣孝	蔣	孝	惟忠
陳士元	陳	士元	心叔
遲鳳翔	遲	鳳翔	德徵
鄔璉	鄔	璉	宜瑩
計士元	計	士元	允卿
陶欽臯	陶	欽臯	克允
劉朝佐	劉	朝佐	道卿
楊師震	楊	師震	子畏
劉爾牧	劉	爾牧	成卿
朱大器	朱	大器	自充
熊汝達	熊	汝達	德明
畢鏘	畢	鏘	廷鳴
何一舉	何	一舉	德卿
范階	范	階	景志
王一陽	王	一陽	子復
藺子充	藺	子充	仲實
李臨陽	李	臨陽	汝貞
吳朝鳳	吳	朝鳳	鳴仲
康迪吉	康	迪吉	道甫
陳淮	陳	淮	豫之
曹三暘	曹	三暘	子泰
姜良翰	姜	良翰	希召
劉鳳	劉	鳳	文起
申价	申	价	懋德
陳其學	陳	其學	宗孟
吉來獻	吉	來獻	子欽
章熙	章	熙	堯載
馬錫	馬	錫	伯厚
張承憲	張	承憲	監先
趙世奎	趙	世奎	啟文
葉材	葉	材	達卿
霍冀	霍	冀	堯封
任璜	任	璜	北玉
文方	文	方	子靜
張德熹	張	德熹	宗儒
黃國卿	黃	國卿	君任
尚薰	尚	薰	德馨
李檀	李	檀	子薦
陳絳	陳	絳	用陽
蔣賁	蔣	賁	子素
王民	王	民	暤如
朱熙載	朱	熙載	懋勳
徐易	徐	易	希文
向洪邁	向	洪邁	景臯
俞介	俞	介	仲和
錢嶧	錢	嶧	景魯
金九成	金	九成	鳴韶
洪遇	洪	遇	伯時
任環	任	環	應乾
趙世錄	趙	世錄	汝公
歐陽震	歐陽	震	起叔
閭東	閭	東	啟明
盧岐嶷	盧	岐嶷	希稷
唐守勳	唐	守勳	允懋
孫昭	孫	昭	明德
王本固	王	本固	子民
倪潤	倪	潤	伯雨
俞時歆	俞	時歆	伯駿
丘秉文	丘	秉文	鳴周
王斛	王	斛	應萬
繆宣	繆	宣	時化
王光祖	王	光祖	子孝
宋國華	宋	國華	崇樂
胡汝安	胡	汝安	恭甫
劉時進	劉	時進	子亨
胡景榮	胡	景榮	子仁
張才	張	才	茂參
張承敘	張	承敘	懷德
劉祿	劉	祿	惟學
張志學	張	志學	叔行
郭維藩	郭	維藩	价夫
王楠	王	楠	子梁
王鳴臣	王	鳴臣	汝文
戚慎	戚	慎	汝初
蔡朴	蔡	朴	子初
陳大賓	陳	大賓	敬夫
趙錦	趙	錦	元朴
朱繪	朱	繪	白甫
吉澄	吉	澄	靜甫
嚴天祥	嚴	天祥	叔善
張鑑	張	鑑	汝明
劉應箕	劉	應箕	維南
甘觀	甘	觀	貞父
高光	高	光	子謙
申思夔	申	思夔	汝一
汪克用	汪	克用	子才
俞乾	俞	乾	一清
萬寀	萬	寀	一和
王學	王	學	師古
張錬	張	錬	伯純
張侃	張	侃	巽卿
何海晏	何	海晏	治象
葛桷	葛	桷	安甫
錢仕	錢	仕	忠甫
薛樟	薛	樟	子喬
谷中虛	谷	中虛	子聲
凌汝志	凌	汝志	雲鵠
陳甘雨	陳	甘雨	應時
席上珍	席	上珍	聘之
李九功	李	九功	惟敘
王宗性	王	宗性	繼善
趙孔昭	趙	孔昭	子潛
栗永祿	栗	永祿	士學
陳昌言	陳	昌言	德夫
楊選	楊	選	以公
蕭一鶚	蕭	一鶚	爾薦
王鶴	王	鶴	子皋
王順德	王	順德	叔昌
黃希周	黃	希周	宗魯
馮應麟	馮	應麟	德及
李淳	李	淳	彥穆
申旞	申	旞	儀卿
江珍	江	珍	民璞
張嵐	張	嵐	雲少
石鯨	石	鯨	應聲
馬快	馬	快	汝勵
張廷栢	張	廷栢	壽卿
張邦彥	張	邦彥	允楨
姜廷頤	姜	廷頤	以正
孫坊	孫	坊	志國
朱曰藩	朱	曰藩	子价
俞謹	俞	謹	懋庸
李廷春	李	廷春	元甫
李汝蘭	李	汝蘭	秀夫
烏從善	烏	從善	汝登
金九齡	金	九齡	與壽
郭公週	郭	公週	景復
朱有孚	朱	有孚	子貞
馬汝松	馬	汝松	節甫
劉體乾	劉	體乾	子元
李萬實	李	萬實	少虛
賀承光	賀	承光	子謙
沈束	沈	束	宗安
蘇志仁	蘇	志仁	道先
劉自強	劉	自強	體乾
吳昶	吳	昶	伯明
林懋舉	林	懋舉	直卿
張祦	張	祦	介福
任希祖	任	希祖	元孝
冀鍊	冀	鍊	純夫
塗澤民	塗	澤民	志伊
叚鑂	叚	鑂	文貴
李文麟	李	文麟	應楨
胡惟中	胡	惟中	可久
吳嶽	吳	嶽	宗泰
謝讜	謝	讜	獻忠
朱木	朱	木	子喬
劉檟	劉	檟	元美
郝鳴陰	郝	鳴陰	子和
邵漳	邵	漳	子清
楊廷相	楊	廷相	爕甫
邊洵	邊	洵	文允
徐洛	徐	洛	子京
姚一元	姚	一元	惟貞
鄭河	鄭	河	師程
汪一中 	汪	一中 	正叔
許彥忠	許	彥忠	汝敬
孫慎	孫	慎	用脩
徐綱	徐	綱	立之
陳信	陳	信	子行
牛珠	牛	珠	光甫
林應奎	林	應奎	德暉
王之誥	王	之誥	告若
石茂華	石	茂華	君采
宋□	宋	□	及甫
趙宸	趙	宸	德聰
高鏞	高	鏞	景甫
金淛 	金	淛 	汝東
成于學	成	于學	懷道
張守直	張	守直	時舉
周世遠	周	世遠	子道
馬汝驥	馬	汝驥	德甫
蔡揚金	蔡	揚金	子礪
彭應麟	彭	應麟	太符
傅卿	傅	卿	獻卿
孫學古	孫	學古	汝□
馬震章	馬	震章	國華
徐承祖	徐	承祖	克修
嚴清	嚴	清	直卿
盧寧	盧	寧	忠獻
李恕	李	恕	道夫
徐公遴	徐	公遴	舉之
魏文焲	魏	文焲	德章
郭邦光	郭	邦光	元賓
張邦彥	張	邦彥	德崇
韓朝江	韓	朝江	順甫
徐行可	徐	行可	子恕
李僑	李	僑	子高
周美	周	美	濟叔
陸州	陸	州	汝行
左旦	左	旦	君發
都文奎	都	文奎	彥卿
趙彥章	趙	彥章	徵甫
沈科	沈	科	子進
宿應參	宿	應參	文炳
楊應元	楊	應元	伯仁
尤瑛	尤	瑛	汝白
何尚賢	何	尚賢	汝恩
李尚智	李	尚智	汝愚
胡志夔	胡	志夔	鳴和
林軏	林	軏	濟遠
梁恩	梁	恩	子承
張達	張	達	懋德
張守蒙	張	守蒙	啟哲
劉景韶	劉	景韶	子成
李華魯	李	華魯	季榮
羅文蔚	羅	文蔚	變夫
李初元	李	初元	少貞
王國光	王	國光	汝觀
趙祖元	趙	祖元	宗仁
朱寵	朱	寵	德承
張子順	張	子順	聚甫
汪任	汪	任	子仁
殷從儉	殷	從儉	汝中
裘仕濂	裘	仕濂	子憲
楊敷	楊	敷	震卿
李庭桂	李	庭桂	子馨
陳璨	陳	璨	德潤
陳效古	陳	效古	武周
萬善	萬	善	一之
邵稷	邵	稷	子嘉
楊允繩	楊	允繩	翼少
趙輄	趙	輄	以載
曹鈿	曹	鈿	右文
申仲	申	仲	次孟
張廷槐	張	廷槐	子徵
何璋	何	璋	國珍
金豪	金	豪	文興
陳全之	陳	全之	粹中
李燧	李	燧	晦夫
戴才	戴	才	大需
李逢時	李	逢時	化甫
王宗聖	王	宗聖	汝學
李攀龍	李	攀龍	于麟
范充濁	范	充濁	清夫
靳學曾	靳	學曾	子魯
李春芳	李	春芳	子實
張春	張	春	仁伯
胡正蒙	胡	正蒙	正伯
亢思謙	亢	思謙	子益
汪鏜孫	汪	鏜孫	振宗
惲紹芳	惲	紹芳	光世
史朝賓	史	朝賓	應之
曹金	曹	金	汝礪
張正和	張	正和	以禮
黎澄	黎	澄	本靜
黃鑄	黃	鑄	國範
張居正	張	居正	叔大
胡杰	胡	杰	子文
楊繼盛	楊	繼盛	仲芳
楊豫孫	楊	豫孫	幼殷
高超	高	超	廷華
奚世亮	奚	世亮	仲明
章世仁	章	世仁	元卿
任惟鈞	任	惟鈞	子範
莫如士	莫	如士	子元
謝登之	謝	登之	汝學
王惟恕	王	惟恕	行甫
徐光啟	徐	光啟	叔賢
張邦彥	張	邦彥	才甫
王時槐	王	時槐	子植
楊世芳	楊	世芳	懋德
史闕疑	史	闕疑	子慎
王一夔	王	一夔	章夫
陳夢鶴	陳	夢鶴	子羽
徐陟	徐	陟	子明
耿隨朝	耿	隨朝	子衡
蔡用乂	蔡	用乂	行甫
吳國相	吳	國相	楹甫
凌雲翼	凌	雲翼	汝成
朱笈	朱	笈	懋學
熊琦	熊	琦	憲韓
藍璧	藍	璧	完卿
丘瓚	丘	瓚	獻卿
翁時器	翁	時器	德卿
陸九成	陸	九成	子韶
李敬	李	敬	直夫
王春澤	王	春澤	以潤
顧柄	顧	柄	文謙
彭登瀛	彭	登瀛	選之
吳衍	吳	衍	子蕃
張勉學	張	勉學	益甫
蔡文	蔡	文	孚中
蔡鑰	蔡	鑰	伯啟
劉芹	劉	芹	子獻
黎遵訓	黎	遵訓	孝若
梁佐	梁	佐	應台
任士憑	任	士憑	可依
張東周	張	東周	子用
張元諭	張	元諭	伯啟
王有為	王	有為	希顏
顧言	顧	言	子行
張任	張	任	希尹
莊朝賓	莊	朝賓	于觀
黃世科	黃	世科	子登
任有齡	任	有齡	夢錫
周思兼	周	思兼	叔夜
林一新	林	一新	震起
宋守志	宋	守志	貞甫
劉斯潔	劉	斯潔	原靜
梁明翰	梁	明翰	維憲
李三畏	李	三畏	汝敬
史直臣	史	直臣	子忠
黃元恭	黃	元恭	資禮
顧允揚	顧	允揚	懋稱
姚九功	姚	九功	惟敘
宋文明	宋	文明	汝化
劉應時	劉	應時	子易
林一新	林	一新	躋夫
何鏜	何	鏜	振卿
張西銘	張	西銘	原仁
宋曰仁	宋	曰仁	思表
李一元	李	一元	調卿
李景萃	李	景萃	德聚
張希賢	張	希賢	尚友
汪烇	汪	烇	子光
萬思謙	萬	思謙	益甫
李心學	李	心學	建中
王世貞	王	世貞	元美
江治	江	治	順之
朱天俸	朱	天俸	子學
胡朝臣	胡	朝臣	汝鄰
王良貴	王	良貴	少思
徐文沔	徐	文沔	可繩
李郁	李	郁	文甫
紀璿	紀	璿	天儀
金銑	金	銑	子良
周鏜	周	鏜	德揚
張思敬	張	思敬	伯安
熊勉學	熊	勉學	懋倫
陳一松	陳	一松	宗岩
高尚文	高	尚文	從周
賀鏤	賀	鏤	邦器
陶承學	陶	承學	子述
劉涇	劉	涇	叔清
錢鯨	錢	鯨	叔鳴
姚仕顯	姚	仕顯	原學
宋廷表	宋	廷表	進之
楊美益	楊	美益	以謙
樊獻科	樊	獻科	文叔
李幼滋	李	幼滋	元樹
謝江	謝	江	仲川
孫永思	孫	永思	性孝
王樵	王	樵	明逸
吳仲禮	吳	仲禮	思立
龐俊	龐	俊	孟章
毛起	毛	起	潛賓
張謐	張	謐	子靖
楊守魯	楊	守魯	允得
鄭本立	鄭	本立	充道
張淵	張	淵	惟本
張敦復	張	敦復	叔中
孫世芳	孫	世芳	克承
王尚禮	王	尚禮	敘夫
陸佐	陸	佐	子翼
彭範	彭	範	克憲
甘茹	甘	茹	征甫
馬一龍	馬	一龍	負圖
李昭祥	李	昭祥	元韜
陳善治	陳	善治	時化
張言	張	言	思默
詹萊	詹	萊	殷行
韓弼	韓	弼	汝良
張可述	張	可述	惟孝
白大用	白	大用	幼權
李儒烈	李	儒烈	忠甫
徐敦	徐	敦	叔厚
俞時及	俞	時及	伯雨
李應時	李	應時	際可
邵德	邵	德	明甫
郝成性	郝	成性	存甫
王健	王	健	于行
呂孔良	呂	孔良	子性
王鈴	王	鈴	子才
袁洪愈	袁	洪愈	抑之
劉世魁	劉	世魁	伯春
林燫	林	燫	貞恒
李秋	李	秋	伯成
徐可相	徐	可相	懋忠
徐承嗣	徐	承嗣	克敬
郭鑰	郭	鑰	啟之
張來徵	張	來徵	獻孚
孫允中	孫	允中	汝時
羅椿	羅	椿	元齡
莊應禎	莊	應禎	希周
邊毅	邊	毅	德弘
鄭東白	鄭	東白	叔曉
吳遵	吳	遵	公路
劉廷梅	劉	廷梅	與和
孫汝賢	孫	汝賢	允功
龔愷	龔	愷	次元
韓子允	韓	子允	明仲
于業	于	業	建公
黃季瑞	黃	季瑞	宗和
李天榮	李	天榮	仁卿
曹禾	曹	禾	世嘉
皇甫渙	皇甫	渙	時亨
朱伯辰	朱	伯辰	文拱
周如斗	周	如斗	允文
黃履旋	黃	履旋	性之
袁光翰	袁	光翰	憲甫
程嗣功	程	嗣功	汝懋
蕭禹臣	蕭	禹臣	子益
吳伯朋	吳	伯朋	惟錫
沈淮	沈	淮	澂伯
李遇元	李	遇元	應乾
章美中	章	美中	道華
李守仁	李	守仁	與安
邵惟中	邵	惟中	希舜
王遴	王	遴	慎徵
黃扆	黃	扆	思瞻
孟官	孟	官	惟正
林騰蛟	林	騰蛟	士才
錢鑪	錢	鑪	汝化
金勿	金	勿	希顏
郭東藩	郭	東藩	鎮夫
蕭汝默	蕭	汝默	時言
陳惟舉	陳	惟舉	直孚
郭仁	郭	仁	靜甫
張雲路	張	雲路	伯登
黃元白	黃	元白	用章
李承華	李	承華	實甫
劉修己	劉	修己	以敬
姚唐	姚	唐	時雍
高躍	高	躍	文化
閻繩芳	閻	繩芳	世武
陳學夔	陳	學夔	汝諧
岳粹	岳	粹	純甫
張嘉孚	張	嘉孚	以貞
方祥	方	祥	履祥
屈諫	屈	諫	正父
李价	李	价	少藩
羅鴻	羅	鴻	廷猷
李彬	李	彬	國華
殷士儋	殷	士儋	正甫
汪道昆	汪	道昆	玉卿
劉崇文	劉	崇文	原質
陸燦	陸	燦	晦甫
李佑	李	佑	吉甫
祁清	祁	清	子揚
黃墱	黃	墱	元登
鄭真	鄭	真	惟誠
丘岳	丘	岳	子瞻
段錦	段	錦	美中
丘緯	丘	緯	世章
劉秉仁	劉	秉仁	子元
戴愬	戴	愬	遠之
王惟善	王	惟善	衷甫
鄭銘	鄭	銘	警吾
楊巍	楊	巍	伯謙
祝天保	祝	天保	惟忠
陳言	陳	言	宜昌
李如桂	李	如桂	希竇
丘預達	丘	預達	若孚
吳俊	吳	俊	子魯
狄斯彬	狄	斯彬	文中
張柱	張	柱	汝任
張天復	張	天復	復亨
陳觀衡	陳	觀衡	季平
李敏德	李	敏德	伯修
郭民敬	郭	民敬	子莊
蔡亨嘉	蔡	亨嘉	元會
王陳策	王	陳策	師董
劉梁	劉	梁	廷材
眭明才	眭	明才	哲卿
賀涇	賀	涇	汝明
蔣勳	蔣	勳	子忠
朱文漢	朱	文漢	章卿
徐鷁	徐	鷁	鳴川
章适	章	适	景南
樂其雅	樂	其雅	必所
張萬紀	張	萬紀	舜卿
楊海	楊	海	汝容
葉應麟	葉	應麟	時瑞
陳嘉謨	陳	嘉謨	世顯
高士	高	士	淳甫
秦梁	秦	梁	子成
黃胐	黃	胐	文輝
毛鵬	毛	鵬	汝南
葉應乾	葉	應乾	際清
胡曉	胡	曉	東白
趙鏜	趙	鏜	仲聲
徐栻	徐	栻	世寅
莊蒞民	莊	蒞民	善甫
劉魯生	劉	魯生	希孔
馬三才	馬	三才	思參
汪芸	汪	芸	秀卿
沈晃	沈	晃	克昭
張師載	張	師載	以道
何璿	何	璿	德齊
蘇繼	蘇	繼	子志
宋儀望	宋	儀望	望之
朱綱	朱	綱	振甫
王任用	王	任用	汝欽
王大猷	王	大猷	世升
王宗茂	王	宗茂	時育
周璞	周	璞	元治
耿隨卿	耿	隨卿	子承
彭輅	彭	輅	子殷
韓叔陽	韓	叔陽	健甫
張冕	張	冕	莊甫
沈紹德	沈	紹德	純甫
徐衍祚	徐	衍祚	子厚
朱大韶	朱	大韶	象玄
高尚志	高	尚志	以達
曾承芳	曾	承芳	英遇
卜大有	卜	大有	謙夫
郭中	郭	中	子立
鄭綺	鄭	綺	汝文
唐時舉	唐	時舉	汝賢
李先芳	李	先芳	伯承
王三接	王	三接	晉甫
陳瓚	陳	瓚	敬夫
楊鑰	楊	鑰	啟之
張芹	張	芹	獻之
喻顯科	喻	顯科	時晉
陰秉暘	陰	秉暘	子寅
賈天爵	賈	天爵	子修
徐懷愛	徐	懷愛	曰民
楊經	楊	經	子正
苗敏學	苗	敏學	以勤
李豸	李	豸	子仁
陸光祖	陸	光祖	與繩
周恂懋	周	恂懋	季實
劉錫	劉	錫	德純
殷正茂	殷	正茂	養實
李敏	李	敏	鈍甫
樓鎮	樓	鎮	子安
劉應節	劉	應節	子和
胡致和	胡	致和	順天
張愉	張	愉	孝徵
詹珊	詹	珊	廷佩
李詩	李	詩	以興
孫裒	孫	裒	益之
賈衡	賈	衡	守準
何琚	何	琚	佩甫
呂廕	呂	廕	承之
唐汝楫	唐	汝楫	思濟
呂調陽	呂	調陽	和卿
姜金和	姜	金和	節之
田楊	田	楊	廷翰
陳諫	陳	諫	信可
宗臣	宗	臣	子相
包應麟	包	應麟	子瑞
林烶章	林	烶章	繼暉
金立敬	金	立敬	中夫
黃士觀	黃	士觀	國光
方弘靜	方	弘靜	定之
傅夏器	傅	夏器	廷璜
羅一道	羅	一道	貫卿
陳元琰	陳	元琰	仲文
欽拱極	欽	拱極	子辰
陸綸	陸	綸	理之
游天廷	游	天廷	士達
黃憲卿	黃	憲卿	弘度
張守宗	張	守宗	繼先
李光宸	李	光宸	仲熙
魏裳	魏	裳	順甫
胡膏	胡	膏	來霑
李淑	李	淑	師孟
熊桴	熊	桴	元乘
白啟常	白	啟常	伯倫
李玳	李	玳	廷實
任民望	任	民望	子重
張榮	張	榮	仁卿
范檟	范	檟	子美
鄭逑	鄭	逑	世美
吳炳庶	吳	炳庶	朝徵
何思贊	何	思贊	紹襄
張蘊	張	蘊	一貞
黃甲	黃	甲	首卿
曹麟	曹	麟	汝祥
徐學詩	徐	學詩	子言
梁有譽	梁	有譽	公實
郭應聘	郭	應聘	君賓
王獻圖	王	獻圖	應祥
曹天祐	曹	天祐	有卿
萬仲	萬	仲	彥和
何寬	何	寬	汝肅
周詔	周	詔	若師
王三接	王	三接	允康
王道行	王	道行	明輔
陳應和	陳	應和	文祥
呂燿	呂	燿	思晦
胡庭蘭	胡	庭蘭	伯賢
沈應魁	沈	應魁	仲文
柯本	柯	本	正之
金立愛	金	立愛	元夫
楊一和	楊	一和	貞甫
高岱	高	岱	伯宗
李春芳	李	春芳	實夫
徐中行	徐	中行	子與
周希哲	周	希哲	叔愚
劉衍祚	劉	衍祚	淑嗣
許嶽	許	嶽	子峻
章懋	章	懋	世功
朱天球	朱	天球	君玉
莫如善	莫	如善	子明
馮皐謨	馮	皐謨	明卿
吳一儒	吳	一儒	望魯
陳茂禮	陳	茂禮	履卿
閻光潛	閻	光潛	孔昭
李纉	李	纉	存孝
李慎	李	慎	克念
田汝麟	田	汝麟	子仁
邵齡	邵	齡	汝仁
歐珮	歐	珮	聲甫
張選	張	選	士直
蒙大賚	蒙	大賚	善卿
余應舉	余	應舉	德甫
王叔果	王	叔果	育德
李伸	李	伸	道卿
周後叔	周	後叔	胤昌
陳柯	陳	柯	君則
胡憲仲	胡	憲仲	文澄
吳崧	吳	崧	中望
方邦慶	方	邦慶	以賢
柳宗葵	柳	宗葵	公獻
范大儒	范	大儒	子師
薛天華	薛	天華	思素
黃大節	黃	大節	克完
孟羽正	孟	羽正	仲禹
喻褧	喻	褧	彥章
崔學履	崔	學履	伯和
余田	余	田	舜耕
聶瀛	聶	瀛	汝登
郝守業	郝	守業	子述
陳瑞龍	陳	瑞龍	體乾
王應時	王	應時	懋行
李彥士	李	彥士	惟聘
丁自申	丁	自申	朋嶽
陳栢	陳	栢	憲卿
蹇來譽	蹇	來譽	子修
諸暲	諸	暲	子誠
孫塘	孫	塘	子源
崔都	崔	都	民極
何廷鈺	何	廷鈺	潤夫
呂陽	呂	陽	調陽
詹理	詹	理	爕卿
趙鏘	趙	鏘	子振
王价	王	价	維藩
李邦珍	李	邦珍	子玉
閻望雲	閻	望雲	大濟
錢庶	錢	庶	國徵
王輿	王	輿	仲任
丘鵬	丘	鵬	志弘
傅鳴會	傅	鳴會	汝嘉
李鳳毛	李	鳳毛	于翔
高鶴	高	鶴	若齡
吳國寶	吳	國寶	懋賢
李方至	李	方至	如川
符允中	符	允中	汝執
袁汝是	袁	汝是	公孺
王極	王	極	伯準
劉一麟	劉	一麟	子仁
張楙	張	楙	子培
湯日新	湯	日新	懋昭
鄭一龍	鄭	一龍	于田
張益	張	益	舜卿
葉恩	葉	恩	嗣光
趙河	趙	河	伯泓
陳道基	陳	道基	以中
黃朝聘	黃	朝聘	希尹
張師价	張	師价	伯垣
王希堯	王	希堯	汝仁
鄭存仁	鄭	存仁	子義
崔近思	崔	近思	希睿
陸柬	陸	柬	道函
孫濬	孫	濬	宗禹
羅瑤	羅	瑤	國華
呂焯	呂	焯	文華
王應璧	王	應璧	賓之
張蕙	張	蕙	時芳
尤烈	尤	烈	子偉
朱景賢	朱	景賢	範之
劉勃	劉	勃	仲安
查絳	查	絳	汝素
曹光	曹	光	原實
王正國	王	正國	佐之
李一經	李	一經	子源
楊元吉	楊	元吉	來貞
周良寏	周	良寏	以介
黃正色	黃	正色	則徵
況叔祺	況	叔祺	吉夫
譙思	譙	思	叔通
陳典	陳	典	子厚
唐世隆	唐	世隆	德亨
王用賢	王	用賢	伯純
毛汝麒	毛	汝麒	伯祥
麻濟邦	麻	濟邦	子忠
宋登	宋	登	子瀛
湯賓	湯	賓	繼寅
沈紹慶	沈	紹慶	子善
沈陽	沈	陽	復卿
董遂	董	遂	叔良
沈應乾	沈	應乾	惟順
鄭佶	鄭	佶	元健
蕭可教	蕭	可教	子修
衛東吳	衛	東吳	叔京
屠仲律	屠	仲律	宗豫
苟頴	苟	頴	希顏
王道直	王	道直	子繩
羅緯	羅	緯	宿甫
郭立彥	郭	立彥	如選
顧弘潞	顧	弘潞	敬文
陳慶	陳	慶	履旋
操守經	操	守經	仲權
潘季馴	潘	季馴	時良
陳經	陳	經	汝濟
趙理	趙	理	性甫
翁夢鯉	翁	夢鯉	希登
黃謙	黃	謙	亨夫
劉克學	劉	克學	子行
朱安期	朱	安期	子和
李正彞	李	正彞	德敘
王諍	王	諍	子孝
王用康	王	用康	允靖
董傳策	董	傳策	原漢
崔棟	崔	棟	孔材
傅汝礪	傅	汝礪	若金
丘橓	丘	橓	懋實
丘文學	丘	文學	子晉
紀鳳鳴	紀	鳳鳴	明瑞
柳希玭	柳	希玭	子敬
王潺	王	潺	公沛
袁世榮	袁	世榮	子仁
劉效祖	劉	效祖	仲修　
徐應	徐	應	順叔
趙周	趙	周	子郁
王應顯	王	應顯	惟謨
謝教	謝	教	敬敷
許公高	許	公高	德升
尹庭	尹	庭	子紹
林兆金	林	兆金	懋南
卓爾	卓	爾	見可
劉炌	劉	炌	元白
馬斯臧	馬	斯臧	遠謨
楊惟平	楊	惟平	君正
周國卿	周	國卿	台仲
魯邦彥	魯	邦彥	朝選
侯東萊	侯	東萊	儒宗
胡崇曾	胡	崇曾	參伯
孫佳	孫	佳	志完
王汝安	王	汝安	子樂
曹本	曹	本	子中
徐鼎	徐	鼎	思重
薛如淮	薛	如淮	東卿
郭良璞	郭	良璞	卞玉
段顧言	段	顧言	汝行
周汝器	周	汝器	子才
施堯臣	施	堯臣	欽甫
趙文同	趙	文同	一重
任良貴	任	良貴	汝爵
馬濂	馬	濂	濬卿
張傑夫	張	傑夫	朝伯
衛心	衛	心	之正
張燈	張	燈	文輝
方正脩	方	正脩	仲安
時通	時	通	睿夫
高敏學	高	敏學	希曾
路楷	路	楷	子中
姚世熙	姚	世熙	思載
牟蓁	牟	蓁	以登
盧鎰	盧	鎰	君萬
沈應時	沈	應時	子易
孫榮仁	孫	榮仁	惟善
姚邦材	姚	邦材	掄伯　
曹司賢	曹	司賢	名卿
王如綸	王	如綸	汝言
麻瀛	麻	瀛	登之
樊鍾岱	樊	鍾岱	東望
於聞	於	聞	子行
吳翰詞	吳	翰詞	子脩
劉畿	劉	畿	朝宗
岑遠	岑	遠	昂霄
錢鑄	錢	鑄	宗顏
黃垣	黃	垣	拱辰
王守充	王	守充	美中
秦鈁	秦	鈁	鳴和
張雲霖	張	雲霖	子潤
紀公廵	紀	公廵	恒甫
陳宗虞	陳	宗虞	于韶
宋繼先	宋	繼先	子孝
張峯	張	峯	維直
羅元禎	羅	元禎	汝符
欒尚約	欒	尚約	孔源
方攸躋	方	攸躋	君敬
周岱	周	岱	伯宗
王汝述	王	汝述	朝明
周秀	周	秀	實卿
陶天忠	陶	天忠	舜佐
楊守愚	楊	守愚	子發
文希儒	文	希儒	真卿
陳耀文	陳	耀文	晦伯
劉贄	劉	贄	子禮
王元春	王	元春	孟和
姚紹祖	姚	紹祖	景芳
吳一瀾	吳	一瀾	汝觀
昌應時	昌	應時	廷佐
江一川	江	一川	體行
萬民英	萬	民英	子才
劉光遠	劉	光遠	子旭
譚臬	譚	臬	朝憲
顏會	顏	會	禮卿
裴天祐	裴	天祐	順之
孫銳	孫	銳	希純
蹇應祺	蹇	應祺	伯吉
彭繼業	彭	繼業	大芳
牛輗	牛	輗	伯行
趙時舉	趙	時舉	存晦
鄭逢陽	鄭	逢陽	道亨
錢錞	錢	錞	鳴叔
陶應龍	陶	應龍	文化
鄭國賓	鄭	國賓	汝嘉
王文翰	王	文翰	則野
陳斗南	陳	斗南	子一
巫繼咸	巫	繼咸	宗臣
張佳胤	張	佳胤	肖甫
吳國倫	吳	國倫	明可
王杰	王	杰	子秀
鄭伯興	鄭	伯興	子振
康世耀	康	世耀	子潛
王喬年	王	喬年	耆卿
謝莆	謝	莆	符德
李體	李	體	仲全
王言	王	言	子大
夏栻	夏	栻	廷瞻
楊乾亨	楊	乾亨	啟元
張昇	張	昇	伯東
喬光大	喬	光大	子充
許爚	許	爚	文升
丁希孔	丁	希孔	顏學
文階	文	階	克升
丁永成	丁	永成	子觀
王鈇	王	鈇	德威
鍾崇武	鍾	崇武	季烈
陳治安	陳	治安	超誼
萬虞龍	萬	虞龍	言卿
孫應魁	孫	應魁	元之
劉廷舉	劉	廷舉	直卿
錢之選	錢	之選	舜臣
嚴杰	嚴	杰	子俊
馬鈇	馬	鈇	肅容
毛孔墀	毛	孔墀	茂對
王好問	王	好問	裕卿
張時	張	時	宗易
王納講	王	納講	亦頤
韓詢	韓	詢	子虛
鄧棟	鄧	棟	少隆
林大春	林	大春	邦陽
錢有威	錢	有威	維重
劉一檜	劉	一檜	士奇
張四知	張	四知	子畏
陳策	陳	策	效愚
毛文邦	毛	文邦	希周
林養高	林	養高	汝貞
楊得春	楊	得春	東卿
陳謹	陳	謹	德言
曹大章	曹	大章	一呈
溫應祿	溫	應祿	以雍
萬浩	萬	浩	汝孟
劉師頴	劉	師頴	方回
陳綰	陳	綰	用章
龐遠	龐	遠	惟明
姚弘謨	姚	弘謨	繼文
秦宗道　	秦	宗道　	仲學
陸瓚	陸	瓚	邦器
何東序	何	東序	崇教
張志孝	張	志孝	永錫
許汝驥	許	汝驥	德卿
羅廷紳	羅	廷紳	公書
楊準	楊	準	汝平
葉萬祿	葉	萬祿	惟學
黃鈞	黃	鈞	叔秉
李如松	李	如松	子茂
莊士元	莊	士元	君聘
李貴	李	貴	廷良
呂穆	呂	穆	宗文
胡麟	胡	麟	伯祥
趙祖朝	趙	祖朝	宗正
呂旻	呂	旻	仁甫
江一麟	江	一麟	仲文
何寵	何	寵	汝錫
郭敬賢	郭	敬賢	希堯
梁夢龍	梁	夢龍	乾吉
齊遇	齊	遇	士賓
鄒察	鄒	察	明卿
周道光	周	道光	子孚
何汝健	何	汝健	體乾
應明德	應	明德	在明
李裘	李	裘	紹冶
吳遵晦	吳	遵晦	明仲
鈔介	鈔	介	右賓
曾鎰	曾	鎰	萬甫
謝鵬舉	謝	鵬舉	仲南
阮文中	阮	文中	用和
孫鳴世	孫	鳴世	應卿
鄧廷猷	鄧	廷猷	汝嘉
張大韶	張	大韶	鳴德
趙與治	趙	與治	道隆
沈志言	沈	志言	子謨
鄭源彬	鄭	源彬	汝宜
徐善慶	徐	善慶	元禎
王希烈	王	希烈	子忠
楊綵	楊	綵	質甫
吳邦楨	吳	邦楨	子寧
祝世廉	祝	世廉	子隅
南軒	南	軒	叔後
姜寶	姜	寶	廷善
王學顏	王	學顏	少潛
趙祖鵬	趙	祖鵬	宗南
徐炳	徐	炳	仲孚
沈繼志	沈	繼志	體道
余朝卿	余	朝卿	汝弼
瞿晟	瞿	晟	景明
徐玭	徐	玭	叔明
胡汝嘉	胡	汝嘉	懋中
馮葉	馮	葉	子奕
夏惟純	夏	惟純	德卿
劉侃	劉	侃	正言
曾一經	曾	一經	正夫
喻南嶽	喻	南嶽	極夫
於惟一	於	惟一	德夫
周賢宣	周	賢宣	仲含
孫應鰲	孫	應鰲	山甫
戴時雍	戴	時雍	逢堯
孫鋌	孫	鋌	文和
張大化	張	大化	原德
屠寬	屠	寬	德宏
桂嘉孝	桂	嘉孝	純甫
方良曙	方	良曙	子賓
周望	周	望	道見
王宇	王	宇	大猷
顧闕	顧	闕	子良
金深	金	深	孔志
李元泰	李	元泰	道隆
徐師曾	徐	師曾	伯魯
金立相	金	立相	道夫
周時中	周	時中	從道
楊一鶚	楊	一鶚	子薦
孔惟德	孔	惟德	恒夫
程金	程	金	德良
王可大	王	可大	元簡
張僊	張	僊	誠之
臧繼芳	臧	繼芳	原實
張四維	張	四維	子維
鍾一元	鍾	一元	太初
周鑑	周	鑑	子明
曾傑	曾	傑	國佐
丘有嵓	丘	有嵓	孔觀
程廷策	程	廷策	汝揚
方萬有	方	萬有	如初
張誼	張	誼	宜言
戴一俊	戴	一俊	惟宅
毛术	毛	术	仲和
林敬	林	敬	確成
蔣焞	蔣	焞	子厚
黎德充	黎	德充	本虛
凌立	凌	立	子中
張問行	張	問行	維誠
徐用光	徐	用光	成孚
汪春時	汪	春時	子育
張正位	張	正位	以立
胡湧	胡	湧	汝原
胡士彥	胡	士彥	世美
李東華	李	東華	景曉
郭文輔	郭	文輔	共臣
姜繼曾	姜	繼曾	守約
顧章志	顧	章志	子行
徐仲楫	徐	仲楫	濟卿
溫如玉	溫	如玉	孟純
方敏	方	敏	汝修
周京	周	京	子依
呂程	呂	程	宗洛
李蓘	李	蓘	子田
吳時來	吳	時來	維脩
徐爌	徐	爌	明宇
李叔和	李	叔和	介甫
蔣應期	蔣	應期	汝昌
曹灼	曹	灼	用晦
王三錫	王	三錫	懷國
苑囿	苑	囿	公甫
衛元吉	衛	元吉	敬之
王其勤	王	其勤	時敏
張求可	張	求可	中甫
李春芳	李	春芳	□實
陳奎	陳	奎	汝星
王學謨	王	學謨	子揚
吳承燾	吳	承燾	仁甫
鍾沂	鍾	沂	宗魯
張九功	張	九功	惟敘
唐自化	唐	自化	伯咸
江北	江	北	拱北
吳可行	吳	可行	子言
陸泰	陸	泰	惟安
馬自強	馬	自強	體乾
蔡本端	蔡	本端	幼貞
葉可成	葉	可成	懋學
梁淮	梁	淮	中行
李瑤	李	瑤	溫甫
趙桐	趙	桐	汝陽
秦禾	秦	禾	子實
殷仁	殷	仁	靜夫
宋儒	宋	儒	子淳
汪汝達	汪	汝達	志行
李璉	李	璉	從啇
黃休泰	黃	休泰	啟大
李從宜	李	從宜	宗賢
鄭茂	鄭	茂	士元
楊文光	楊	文光	誠甫
司馬初	司馬	初	元甫
張巽言	張	巽言	子繹
鄭東	鄭	東	子元
陳懋觀	陳	懋觀	孔質
胡應文	胡	應文	子會
張于逵	張	于逵	鴻與
曾梅	曾	梅	以調
史朝宜	史	朝宜	直之
李應元	李	應元	文徵
楊世鳳	楊	世鳳	應韶
朱賢	朱	賢	進甫
何察	何	察	明甫
楊世第	楊	世第	伯雄
董鯤	董	鯤	化卿
周啟大	周	啟大	自微
楊芷	楊	芷	文植
樊垣	樊	垣	伯師
劉存義	劉	存義	質卿
戚元輔	戚	元輔	希周
慎蒙	慎	蒙	子正
羅汝芳	羅	汝芳	惟德
秦淦	秦	淦	懋清
崔宗堯	崔	宗堯	汝欽
黃仁惠	黃	仁惠	廷敷
劉廓	劉	廓	公藴
周思久	周	思久	子徵
劉堯誨	劉	堯誨	君納
葛慈	葛	慈	伯止
王文炳	王	文炳	道充
俞意	俞	意	子誠
沈寶	沈	寶	邦重
蔡結	蔡	結	國凝
徐梓	徐	梓	汝良
石梁	石	梁	士升
江萬仞	江	萬仞	若度
卜大順	卜	大順	達夫
曹科	曹	科	淑四
楊君璽	楊	君璽	廷信
董世彥	董	世彥	子才
程熟	程	熟	伯生
莫抑	莫	抑	允升
曾廷芝	曾	廷芝	子芳
朱袗	朱	袗	汝衷
陳志	陳	志	思尚
周斯盛	周	斯盛	子才
潘子霓	潘	子霓	望甫
黃吉	黃	吉	子修
劉曰材	劉	曰材	汝成
劉泉	劉	泉	漸甫
萬鵬	萬	鵬	汝南
尹士龍	尹	士龍	見卿
王察言	王	察言	師舜
向淇	向	淇	子瞻
魏濟民	魏	濟民	子仁
朱茹	朱	茹	以彙
盛周	盛	周	文郁
張九一	張	九一	振助
沈維藩	沈	維藩	岳卿
羅嘉賓	羅	嘉賓	興賢
孫喬	孫	喬	子遷
杜實	杜	實	伯潤
溫如春	溫	如春	和甫
金燕	金	燕	尚賓
楊九韶	楊	九韶	成甫
楊棐	楊	棐	賓周
李瑜	李	瑜	季純
秦可大	秦	可大	仲修
柳東伯	柳	東伯	孟卿
張鵬	張	鵬	子摶
戴文奎	戴	文奎	玄明
俞文榮	俞	文榮	國華
呼為卿	呼	為卿	相之
金柱	金	柱	國楨
蕭九峯	蕭	九峯	壽夫
李伯遇	李	伯遇	載純
管嘉福	管	嘉福	正甫
李鳳	李	鳳	鳴岡
陳甲	陳	甲	會先
王宗會	王	宗會	賓之
張待化	張	待化	子魚
吳道直	吳	道直	敬甫
張喬檜	張	喬檜	行節
沈淳	沈	淳	仲龐
李廷龍	李	廷龍	德化
何全	何	全	原學
戴景和	戴	景和	叔宣
李寅實	李	寅實	于中
徐行	徐	行	之弟
劉起蒙	劉	起蒙	養之
董堯封	董	堯封	淑化
王汝正	王	汝正	養之
陳麟	陳	麟	子祥
羅良	羅	良	虞臣
杜時芳	杜	時芳	子實
甄敬	甄	敬	子一
林有望	林	有望	思道
燕仲義	燕	仲義	履道
顧曾唯	顧	曾唯	一貫
張存義	張	存義	宜甫
錢同文	錢	同文	大行
穆寗中	穆	寗中	允執
葛大紀	葛	大紀	伯理
凌儒	凌	儒	真卿
黃森	黃	森	敬蕃
牛山木	牛	山木	子美
趙圭	趙	圭	子重
王彥民	王	彥民	子惟
葉龍	葉	龍	乾甫
祝乾壽	祝	乾壽	以仁
孟重	孟	重	女器
張學顏	張	學顏	子愚
李伯生	李	伯生	子元
黃作孚	黃	作孚	汝從
蕭奇勳	蕭	奇勳	懋建
許從龍	許	從龍	伯雲
喬應光	喬	應光	子實
李瑚	李	瑚	周珎
方時學	方	時學	敏之
陳珊	陳	珊	鳴仲
黃乾行	黃	乾行	叔陽
凌邦奇	凌	邦奇	正伯
王宗舜	王	宗舜	用中
歸大道	歸	大道	懋庸
錢邦偁	錢	邦偁	叔美
葉期遠	葉	期遠	士毅
何棨	何	棨	信卿
華秉中	華	秉中	正夫
郭嵩	郭	嵩	叔中
李佩	李	佩	子玉
王惟寧	王	惟寧	子靜
王宮用	王	宮用	近臣
杜完	杜	完	子脩
晁東吳	晁	東吳	叔泰
江奎	江	奎	國祥
邊傒	邊	傒	志甫
李邦魁	李	邦魁	士元
宋繼祖	宋	繼祖	汝孝
趙教	趙	教	子學
劉鳴陽	劉	鳴陽	應明
林命	林	命	子順
夏儒	夏	儒	汝醇
徐浦	徐	浦	伯源
郭士髦	郭	士髦	召卿
樊倣	樊	倣	一甫
張書紳	張	書紳	思誠
姜儆	姜	儆	君習
孫大學	孫	大學	希曾
黃泮	黃	泮	魯在
周滋	周	滋	伯霖
郭汝霖	郭	汝霖	時望
崔孔昕	崔	孔昕	晉明
劉祜	劉	祜	淑脩
劉以節	劉	以節	叔度
徐大壯	徐	大壯	子貞
姜子羔	姜	子羔	宗孝
史朝富	史	朝富	節之
唐繼祿	唐	繼祿	子崇
路王道	路	王道	汝遵
郭斗	郭	斗	應宿
李一科	李	一科	志道
党緒	党	緒	汝承
王漸	王	漸	斯進
袁祖榮	袁	祖榮	德甫
黃紀	黃	紀	子陳
李希洛	李	希洛	宗程
孫一正	孫	一正	格卿
羅田	羅	田	汝獲
劉凍	劉	凍	汝宗
李從教	李	從教	伯勉
高應芳	高	應芳	惟實
何煃	何	煃	文明
祝堯煥	祝	堯煥	文徵
馮叔吉	馮	叔吉	汝迪
楊旦	楊	旦	汝明
易道談	易	道談	進明
熊坦	熊	坦	履道
張烈文	張	烈文	元煥
成守節	成	守節	子安
史桂芳	史	桂芳	景實
熊逈	熊	逈	叔遠
吳非玉	吳	非玉	得瑩
王汝言	王	汝言	子慎
蕭九成	蕭	九成	汝和
徐耀宗	徐	耀宗	進賢
魏學曾	魏	學曾	惟貫
李得春	李	得春	茂先
戴冕	戴	冕	子端
史起蟄	史	起蟄	德龍
史官	史	官	懋德
馮舜漁	馮	舜漁	澤甫
魏堂	魏	堂	汝高
王業	王	業	惟勤
吳思敬	吳	思敬	德欽
龐尚鵬	龐	尚鵬	少南
田三戒	田	三戒	子慎
沈熙載	沈	熙載	端揆
金應奎	金	應奎	文宿
方攸績	方	攸績	君謙
蘇存	蘇	存	性甫
杜鵬翔	杜	鵬翔	雲翀
曾濂	曾	濂	子濬
毛鋼	毛	鋼	伯鍊
徐節	徐	節	和卿
潘銓	潘	銓	文衡
祝舜齡	祝	舜齡	壽卿
王詠	王	詠	于詩
崔大德	崔	大德	子謙
王大任	王	大任	汝成
雷上儒	雷	上儒	季常
杜璿	杜	璿	子重
陳德騄	陳	德騄	房甫
何惟憼	何	惟憼	汝一
古文炳	古	文炳	仲毨
雷金科	雷	金科	公憲
季永康	季	永康	克雍
張守道	張	守道	希賢
苟延庚	苟	延庚	季壽
侯有功	侯	有功	思謙
黃希憲	黃	希憲	伯容
李一陽	李	一陽	道原
王治	王	治	本道
劉得寬	劉	得寬	幼平
羅廷唯	羅	廷唯	曾甫
王可信	王	可信	子忠
安謙	安	謙	汝光
曾震	曾	震	汝東
謝朝錫	謝	朝錫	懷邦
孫用	孫	用	行可
許宗鎰	許	宗鎰	應衡
王文政	王	文政	道行
季科	季	科	與登
林富春	林	富春	景嚴
侯祁	侯	祁	應文
武金	武	金	礪甫
龔情	龔	情	善甫
吳過	吳	過	檢之
陳瑞	陳	瑞	孔麟
霍超	霍	超	叔謙
劉念	劉	念	克甫
杜棟	杜	棟	孔材
羅復	羅	復	子貞
鄭文茂	鄭	文茂	實夫
張國珍	張	國珍	廷重
盧嘉慶	盧	嘉慶	吉甫
丁盛世	丁	盛世	子逢
王可立	王	可立	子中
張翀	張	翀	子儀
劉溱	劉	溱	子杠
朱裳	朱	裳	則坤
趙宗軌	趙	宗軌	希清
諸大綬	諸	大綬	端甫
陶大臨	陶	大臨	虞臣
金達	金	達	德孚
陳錫	陳	錫	元之
孫鑨	孫	鑨	文中
戴科	戴	科	朝賔
張鳳來	張	鳳來	瑞虞
崔吉	崔	吉	子脩
伍典	伍	典	克從
曹子朝	曹	子朝	以立
張大猷	張	大猷	元敬
陸夢韓	陸	夢韓	與文
田稔	田	稔	慶甫
馮謙	馮	謙	道光
查志立	查	志立	鳴朝
袁随	袁	随	民悅
李鍵	李	鍵	廷守
謝宗明	謝	宗明	子誠
黃翰	黃	翰	可憲
余良翰	余	良翰	邦憲
楊錦	楊	錦	尚綗
嚴文梁	嚴	文梁	子成
阮自嵩	阮	自嵩	惟中
黃文豪	黃	文豪	國英
陳南金	陳	南金	子兼
陰武卿	陰	武卿	定夫
吳一介	吳	一介	元石
楊成	楊	成	汝大
胡孝	胡	孝	民行
趙賢	趙	賢	良弼
方來崇	方	來崇	士功
唐景禹	唐	景禹	治卿
楊宗震	楊	宗震	仲起
鄒光祚	鄒	光祚	承卿
張正謨	張	正謨	以明
杜思	杜	思	子睿
葉宗春	葉	宗春	仁卿
徐紹卿	徐	紹卿	靖甫
邊維垣	邊	維垣	師甫
王凝	王	凝	道甫
胡直	胡	直	正甫
蔡國珎	蔡	國珎	汝聘
鄒善	鄒	善	繼甫
黎桂	黎	桂	克芳
周遜	周	遜	昌言
張相	張	相	文忠
葛邦典	葛	邦典	叙卿
曹梅	曹	梅	子和
祝繼志	祝	繼志	汝德
屠羲英	屠	羲英	淳卿
張人紀	張	人紀	伯脩
陸一鵬	陸	一鵬	應程
吳文華	吳	文華	子彬
陳汲	陳	汲	汝及
胡帛	胡	帛	子行
朱卿	朱	卿	汝弼
李廷觀	李	廷觀	明文
張諧	張	諧	允弼
鄭卿	鄭	卿	君輔
張夢鯉	張	夢鯉	汝化
柴淶	柴	淶	季東
史朝寀	史	朝寀	升之
何顯淑	何	顯淑	晦仲
毛自道	毛	自道	子復
鄭雲鎣	鄭	雲鎣	邦用
姜廷珤	姜	廷珤	國信
項治元	項	治元	熈仲
葉應春	葉	應春	叔華
凌迪知	凌	迪知	稚德
姚體信	姚	體信	汝達
薛一鶚	薛	一鶚	應薦
黃可大	黃	可大	士弘
應存性	應	存性	成之
薛守經	薛	守經	子權
高𡹘	高	𡹘	叔崇
熊俸	熊	俸	應秩
葛綸	葛	綸	理卿
俞汝器	俞	汝器	器之
楊承閔	楊	承閔	子孝
勞堪	勞	堪	任之
張文淵	張	文淵	元靜
施篤臣	施	篤臣	敦甫
楊兆	楊	兆	夢鏡
蕭維翰	蕭	維翰	良甫
程大賔	程	大賔	汝見
楊脩	楊	脩	子吉
劉𥡷	劉	𥡷	朝重
鄭旻	鄭	旻	世穆
介一清	介	一清	子澄
觧明瑞	觧	明瑞	希文
龔大器	龔	大器	用卿
陳選	陳	選	民秀
李承芳	李	承芳	伯輝
沈寅	沈	寅	敬叔
鮑承蔭	鮑	承蔭	子傳
劉行素	劉	行素	易甫
柴祥	柴	祥	汝嘉
李際春	李	際春	應元
馬文徤	馬	文徤	體乾
趙灼	趙	灼	時章
楊銓	楊	銓	朝明
胡文	胡	文	宣文
董學	董	學	希顏
劉志伊	劉	志伊	可任
王楷	王	楷	子正
陳聮芳	陳	聮芳	以成
陳復升	陳	復升	以見
劉思問	劉	思問	汝知
甕蕙	甕	蕙	季芳
方岳	方	岳	鎮伯
查光述	查	光述	子孝
黃廷聘	黃	廷聘	道行
陳旌	陳	旌	儀甫
羅尚德	羅	尚德	希容
孫大霖	孫	大霖	汝濟
劉峴	劉	峴	仁伯
馬出圖	馬	出圖	羲祥
常三省	常	三省	希曾
王三聘	王	三聘	起莘
劉應峰	劉	應峰	少衡
楊汝輔	楊	汝輔	惟德
李汝寛	李	汝寛	嚴夫
陸鳳儀	陸	鳳儀	舜卿
程汝盛	程	汝盛	以怕
張學古	張	學古	道夫
張天馭	張	天馭	叔駕
潘清亶	潘	清亶	懋誠
童承契	童	承契	士成
盧仲佃	盧	仲佃	汝田
賀賁	賀	賁	懋文
張鳴瑞	張	鳴瑞	載禎
杜謙	杜	謙	子益
黎復性	黎	復性	初炳
曹大川	曹	大川	長融
史永壽	史	永壽	仁夫
王尚直	王	尚直	舉之
包檉芳	包	檉芳	起春
胡應嘉	胡	應嘉	祁禮
曹一麟	曹	一麟	伯禮
蔡完	蔡	完	人備
林德	林	德	有本
楊進道	楊	進道	自勉
唐九德	唐	九德	伯懋
戴廷忞	戴	廷忞	懋卿
馮符	馮	符	信伯
陳一謙	陳	一謙	用豫
龔芝	龔	芝	應生
梁棟	梁	棟	伯隆
章汝槐	章	汝槐	子應
李用熒	李	用熒	汝明
侯廷柱	侯	廷柱	子任
何廷錦	何	廷錦	實夫
尚德恒	尚	德恒	汝見
林潤	林	潤	若雨
辛自脩	辛	自脩	子吉
王用中	王	用中	汝一
姚汝循	姚	汝循	叙卿
江潮	江	潮	大潤
蔣弘德	蔣	弘德	宗善
楊衍慶	楊	衍慶	善甫
黃扆	黃	扆	文斷
曾省吾	曾	省吾	以三
胡定	胡	定	明仲
韓怘	韓	怘	子淳
陳所學	陳	所學	行父
楊道亨	楊	道亨	豫甫
黎民衷	黎	民衷	惟和
張膽	張	膽	惟慎
楊標	楊	標	廷瞻
周心易	周	心易	準卿
張一霽	張	一霽	天光
喬伊	喬	伊	良相
袁淳	袁	淳	育真
王得春	王	得春	一元
李啟昭	李	啟昭	升甫
徐必進	徐	必進	以正
張㷆	張	㷆	雲京
王洀	王	洀	道徵
劉子延	劉	子延	體仁
傅希摯	傅	希摯	承弼
張問仁	張	問仁	以元
董懋	董	懋	子功
黃鏌	黃	鏌	元威
汪廷釴	汪	廷釴	彥舉
屠鑣	屠	鑣	希文
黎元	黎	元	叔期
沈桂	沈	桂	仲木
陳紀	陳	紀	仲理
何維復	何	維復	可幾
周舜岳	周	舜岳	良卿
蔡明復	蔡	明復	以脩
趙孟豪	趙	孟豪	汝興
夏時	夏	時	人正
胡汝桂	胡	汝桂	芳甫
趙時齊	趙	時齊	子巽
耿定向	耿	定向	在倫
范以作	范	以作	爾新
溫如璋	溫	如璋	純甫
夏可範	夏	可範	子極
黃錝	黃	錝	崇文
吳宗周	吳	宗周	文甫
郜大經	郜	大經	汝脩
申佐	申	佐	懋良
王道充	王	道充	懋中
袁大誠	袁	大誠	宗正
劉世昌	劉	世昌	仲積
毛汝賢	毛	汝賢	子官
陳應詔	陳	應詔	仲龍
周詩	周	詩	汝學
王嘉言	王	嘉言	獻可
謝封	謝	封	夫錫
祝爾介	祝	爾介	維藩
胡順華	胡	順華	賓南
金甌	金	甌	汝相
杜華	杜	華	歛甫
張銘	張	銘	文粹
湯彬	湯	彬	子雅
張科	張	科	惟進
鄒應龍	鄒	應龍	雲卿
鄭洛	鄭	洛	禹秀
黃九成	黃	九成	子韶
韓宰	韓	宰	子衡
武建邦	武	建邦	懋藎
劉永寧	劉	永寧	以德
李澻	李	澻	世田
倪光薦	倪	光薦	允賢
商誥	商	誥	元寵
王同倫	王	同倫	仲行
張大業	張	大業	原德
卞錫	卞	錫	叔孝
薛曾	薛	曾	師孔
孫丕揚	孫	丕揚	叔孝
楊栢	楊	栢	允節
陳萬言	陳	萬言	道襄
吳朝儀	吳	朝儀	子敬
徐養相	徐	養相	子存
李邦義	李	邦義	宜之
高察	高	察	惟哲
陳子佐	陳	子佐	道誨
李世藩	李	世藩	邦鎮
孫夢豸	孫	夢豸	應兆
晉應槐	晉	應槐	植吾
何邦禮	何	邦禮	大中
許自新	許	自新	試可
漆汝翼	漆	汝翼	行甫
牛鏡	牛	鏡	公照
錢于鄰	錢	于鄰	震卿
左鈞	左	鈞	鳴和
李維	李	維	國張
李思悅	李	思悅	子傳
趙大河	趙	大河	道源
羅崇謙	羅	崇謙	汝益
操時賢	操	時賢	國用
李齊芳	李	齊芳	㓗夫
林叢槐	林	叢槐	應昌
林應雷	林	應雷	宗復
傅思明	傅	思明	遠甫
鄭舜臣	鄭	舜臣	希仁
郭志選	郭	志選	舜舉
吳守	吳	守	化卿
伍令	伍	令	思行
唐汝迪	唐	汝迪	吉甫
陳善道	陳	善道	伯敬
范宗吳	范	宗吳	希淹
蘇朝宗	蘇	朝宗	汝賓
李承式	李	承式	敬甫
郭東	郭	東	仁府
陳瓉	陳	瓉	廷祼
黃誥	黃	誥	汝綸
黃鶚	黃	鶚	子薦
劉孝	劉	孝	子仁
湯應科	湯	應科	體良
顏鯨	顏	鯨	應雷
孟洙	孟	洙	魯川
韓君恩	韓	君恩	元寵
郝杰	郝	杰	彥甫
程純	程	純	子一
張士佩	張	士佩	玟夫
陳忠翰	陳	忠翰	思翊
楊霆	楊	霆	子威
楊旂	楊	旂	汝章
丁堯相	丁	堯相	宗舜
張守貞	張	守貞	從正
蔚鍾	蔚	鍾	萬鍾
盧煌	盧	煌	道舍
鄭大經	鄭	大經	正之
史官	史	官	秉衡
尹校	尹	校	原學
邢守庭	邢	守庭	紹男
劉有誠	劉	有誠	存甫
胡鑰	胡	鑰	畏卿
楊逢節	楊	逢節	應時
任福民	任	福民	錫之
方新	方	新	德新
李世達	李	世達	子成
李時漸	李	時漸	伯鴻
林震	林	震	敦聲
龔錡	龔	錡	台鼎
林文	林	文	恒簡
楊寧	楊	寧	彥謐
薩琦	薩	琦	廷圭
林補	林	補	廷翔
蔡雲漢	蔡	雲漢	九節
程憲	程	憲	伯度
鄭建	鄭	建	弘申
陳璣	陳	璣	叔衡
胡奧	胡	奧	原邃
盧瑛	盧	瑛	克修
劉武	劉	武	士憲
方熙	方	熙	孟明
許南傑	許	南傑	俊才
熊鍊	熊	鍊	學淵
丁倫	丁	倫	子庠
陳詔	陳	詔	廷詢
陸奇	陸	奇	仲謨
李若林	李	若林	若林
吳文	吳	文	克章
吳節	吳	節	與儉
區賢	區	賢	德夫
賴世隆	賴	世隆	德受
劉實	劉	實	加秀
楊祖	楊	祖	自新
高峻	高	峻	行安
葉遄	葉	遄	尹齊
逯端	逯	端	頤正
毛羽	毛	羽	鳳儀
張淑	張	淑	子善
李彬	李	彬	以中
江淵	江	淵	時用
夏銘	夏	銘	自銘
羅寧	羅	寧	士寧
王偡	王	偡	維翰
鄧讓	鄧	讓	敏巽
王復	王	復	從道
陳浩	陳	浩	宗海
王復	王	復	逢吉
陳員韜 	陳	員韜 	從熙
范鎔	范	鎔	九鼎
王玉 	王	玉 	廷器
衛淳	衛	淳	宗元
蕭維禎	蕭	維禎	維禎
葉錫	葉	錫	玄圭
廖莊	廖	莊	安止
時紀	時	紀	德憲
石孟康	石	孟康	孟康
胡端禎  	胡	端禎  	端禎
賀宗	賀	宗	敬祖
劉昭	劉	昭	克明
金貴	金	貴	用和
陳惠	陳	惠	澤民
盧茂 	盧	茂 	景芳
吳寧 	吳	寧 	永清
謝牧 	謝	牧 	謙牧
程 敬                                                                                                                                                                                                                                                           	程	 敬                                                                                                                                                                                                                                                           	孟莊
元亮 	元	亮 	克昭
虞瑛	虞	瑛	廷瓛
張清 	張	清 	子澄
葉儒林	葉	儒林	子賢
柳華	柳	華	彥輝
朱良暹	朱	良暹	士英
范理	范	理	士倫
徐璟	徐	璟	士良
湯鼎	湯	鼎	玉鉉
羅綺	羅	綺	尚綱
沈翼	沈	翼	克敬
趙忠	趙	忠	行恕
徐鐸	徐	鐸	文振
張睿 	張	睿 	志通
張柷	張	柷	起韶
張晳	張	晳	希賢
胡澄	胡	澄	用霖
薛希璉	薛	希璉	庭器
李貴	李	貴	玉瓚
王通	王	通	文達
牛順	牛	順	致和
陳立	陳	立	務本
李素	李	素	尚文
毛宗魯	毛	宗魯	師曾
宋傑	宋	傑	廷英
楊昉	楊	昉	彥明
解貫	解	貫	宗道
張文	張	文	從周
李瓘	李	瓘	廷璧
宋璉	宋	璉	殷徵
鄧履純	鄧	履純	不二
齊整	齊	整	文肅
萬霽	萬	霽	季丙
李璽	李	璽	潮用
白琮	白	琮	廷貴
李棠	李	棠	宗楷
王振	王	振	伯宣
馮顯宗	馮	顯宗	□昌 
范宗	范	宗	宗器
冷遂南	冷	遂南	光遠
徐忠 	徐	忠 	仕信
劉清	劉	清	倣殷
丁士美	丁	士美	邦彥
毛惇元	毛	惇元	裕仁
林士章	林	士章	德斐
陸光祚	陸	光祚	與培
何子壽	何	子壽	康伯
王湜	王	湜	定甫
蔡茂春	蔡	茂春	元卿
吳椿	吳	椿	壽卿
張烈	張	烈	明建
黃宏宇	黃	宏宇	震祥
朱奎	朱	奎	季文　
毛為光	毛	為光	龍伯
林澄源	林	澄源	仲源
陳懋興	陳	懋興	德甫
黃翼	黃	翼	子南
張祥鳶	張	祥鳶	道卿
吳紹	吳	紹	汝復
張仲謙	張	仲謙	士益
李紀	李	紀	邦陳
沈啟原	沈	啟原	道卿
蔡萬	蔡	萬	一之
陳應麟	陳	應麟	子仁
包汴	包	汴	元京
達其道	達	其道	行甫
陳覲	陳	覲	忠甫
陸相儒	陸	相儒	大行
王元敬	王	元敬	廷臣
程學愽	程	學愽	近約
張光漢	張	光漢	為章
劉一儒	劉	一儒	學孔
陶幼學	陶	幼學	子行
呂鳴珂	呂	鳴珂	聲甫
邵畯	邵	畯	子喜
程道東	程	道東	明吾
蔡國熙	蔡	國熙	夢羲
曹一鳳	曹	一鳳	伯儀
陳成甫	陳	成甫	光韶
林奇迪	林	奇迪	敏教
張橋	張	橋	衡如　
郭孝	郭	孝	可忠
衷貞吉	衷	貞吉	孔安
栗魁周	栗	魁周	汝元
尹儒	尹	儒	子珎　
桂枝揚	桂	枝揚	孟遠
楊吉	楊	吉	夢龍
錢鎮	錢	鎮	守中
曾同亨 	曾	同亨 	于野
孫詔	孫	詔	朝宣
林奇材	林	奇材	濟卿
汪如海	汪	如海	汝會
周汝德	周	汝德	時敬
皮豹	皮	豹	文蔚
劉大受	劉	大受	子可
郭廷臣	郭	廷臣	良佐
范燧	范	燧	以木
沈奎	沈	奎	文叔
劉大遺	劉	大遺	廷植
李學禮	李	學禮	子立
周聚星	周	聚星	文卿
王葑	王	葑	德孚
趙宋	趙	宋	子隆
胡僖	胡	僖	伯安
吳允	吳	允	君澤
應存卓	應	存卓	從之
李穟	李	穟	伯實
錢藻	錢	藻	自文
華汝礪	華	汝礪	用成
徐卿龍	徐	卿龍	禹祥
范惟丕	范	惟丕	于公
韓邦憲	韓	邦憲	子成
姜國華	姜	國華	邦實
顧名世 	顧	名世 	莘夫
錢順時	錢	順時	道隆
張子仁	張	子仁	安甫
王闐	王	闐	維振
鄧之屏	鄧	之屏	惟邦
戈九疇	戈	九疇	惟範
游醇卿	游	醇卿	原學
賈選	賈	選	舜舉
胡廷黼	胡	廷黼	元素
宋豫卿	宋	豫卿	子樂
張尚大	張	尚大	時豐
葉憲	葉	憲	德成
歐陽穀	歐陽	穀	仲似
沈節甫	沈	節甫	以安
劉奮庸	劉	奮庸	試可
林燦章	林	燦章	繼顯
田汝頴	田	汝頴	登之
王淑	王	淑	儀甫
陳紹登	陳	紹登	誕先
孫枝	孫	枝	子榮
崔棟	崔	棟	隆吉
潘一桂	潘	一桂	子高
秦嘉楫	秦	嘉楫	少說
胡維新	胡	維新	文化
解宋	解	宋	應儒
王期古	王	期古	克淳
燕儒宦	燕	儒宦	用道
黃襄	黃	襄	國著
陳省	陳	省	孔震
牛若愚	牛	若愚	睿卿
舒化	舒	化	汝德
劉曰睿	劉	曰睿	汝思
雷稽古	雷	稽古	汝徵
王之翰	王	之翰	憲卿
黃鶴	黃	鶴	鳴臯
張德恭	張	德恭	子安
林茂勛	林	茂勛	汝策
汪若泮	汪	若泮	文化
蔡可教	蔡	可教	子受
甄沛	甄	沛	汝澤
查志隆	查	志隆	鳴治
張承賚	張	承賚	良甫
房楠	房	楠	茂材
宿度	宿	度	元周
佘敬中	佘	敬中	子惺
沈子木	沈	子木	汝南
謝東陽	謝	東陽	子生
公一揚	公	一揚	子舉
黃嘉賓	黃	嘉賓	子揚
王儒	王	儒	珍卿
張憲臣	張	憲臣	欽伯
王友賢	王	友賢	希堯
董文寀	董	文寀	汝和
林應節	林	應節	時卿
李思柱	李	思柱	子勝
俞守道	俞	守道	達卿
王天爵	王	天爵	子修
楊廷選	楊	廷選	子庸
趙熙靖	趙	熙靖	敬克
王育仁	王	育仁	延化
荊文炤	荊	文炤	叔韜
邢實	邢	實	道充
賀邦泰	賀	邦泰	道卿
周之屏	周	之屏	伯卿
張進思 	張	進思 	忠甫
王堂	王	堂	以治
游日章	游	日章	學絅
張士純	張	士純	誠叔
歐陽模	歐陽	模	宏甫
黃國華	黃	國華	良實
宋訓	宋	訓	汝式
隨承業	隨	承業	思顯
顧奎	顧	奎	文曜
李遷梧	李	遷梧	茂陽
沈如麒	沈	如麒	朝珍
劉漢儒	劉	漢儒	文卿 
楊應東	楊	應東	子仁
張翰翔	張	翰翔	汝升
李江	李	江	汝貢
王用楨	王	用楨	周行
蔣彬	蔣	彬	原中
湯仰	湯	仰	子山
黃樞	黃	樞	執甫
盧修可	盧	修可	子吉
陳思忠 	陳	思忠 	君衡
蘇松	蘇	松	貞卿
鄧洪震	鄧	洪震	鳴宇
張鹵	張	鹵	召和
岳相 	岳	相 	惟忠
郜光先	郜	光先	子孝
邵夢麟	邵	夢麟	道徵
朱纁	朱	纁	玄甫
嚴從簡	嚴	從簡	仲可
萬慶	萬	慶	子餘
金定	金	定	汝濟
胡執禮	胡	執禮	汝立
石星	石	星	拱辰
陳于陛	陳	于陛	子納
馮成能	馮	成能	子經
宋纁	宋	纁	伯敬
李承選	李	承選	俊卿
俞咨益	俞	咨益	汝虞
劉宗岱	劉	宗岱	伯東
李堯德	李	堯德	性夫
岑用賓	岑	用賓	允穆
劉庠	劉	庠	養吾
沈秱	沈	秱	時秀
高文薦	高	文薦	伯簡
顧堅	顧	堅	元貞
林舜道	林	舜道	允中
歐陽一敬	歐陽	一敬	司直
史嗣元	史	嗣元	懋宗
彭文質	彭	文質	在份
沈人种	沈	人种	時雍
林朝聘	林	朝聘	君珍
蔣三益	蔣	三益	子謙
田登年	田	登年	子登
霍與瑕	霍	與瑕	勉衷
何源	何	源	仲深
張敏德	張	敏德	遜時
羅黃裳	羅	黃裳	美至
陳雲桂	陳	雲桂	君芳
馮善	馮	善	可欲
王君賞	王	君賞	汝懋
魏時亮	魏	時亮	舜卿
夏道南	夏	道南	宗時
鄧楚望	鄧	楚望	思魯
嚴大紀	嚴	大紀	汝肅
朱炳如 	朱	炳如 	仲南
曹自守	曹	自守	伯化
李轍	李	轍	從道
潘儯	潘	儯	文起
徐鉞	徐	鉞	用熙
程光甸 	程	光甸 	子極
何起鳴	何	起鳴	應岐
朱湘	朱	湘	子清
曹棟	曹	棟	隆卿
鄧球	鄧	球	應鳴
雷鳴春	雷	鳴春	肇元
黃緯	黃	緯	煥甫
包大爟	包	大爟	舉之
何永慶	何	永慶	善夫
紀誡	紀	誡	勉夫
劉芬	劉	芬	世馨
徐濬	徐	濬	哲甫
楊鉁	楊	鉁	汝奇
潘良貴	潘	良貴	汝思
樂舜賓	樂	舜賓	宗堯
趙雲程 	趙	雲程 	汝登
張鳳岐	張	鳳岐	鳴治
蔡一槐	蔡	一槐	景明
王徽猷	王	徽猷	天誥
鄭棟	鄭	棟	公宇
楊起元	楊	起元	體仁
樓如山	樓	如山	公安
王愛 	王	愛 	體仁
劉一孚	劉	一孚	貞甫
何思謹	何	思謹	仲勉
李文續	李	文續	德延
徐惟輯	徐	惟輯	汝洽
梅惟和	梅	惟和	元臣
張岳	張	岳	汝宗
趙格	趙	格	君正
王世懋	王	世懋	敬美
賴嘉謨	賴	嘉謨	承卿
郭天祿 	郭	天祿 	子學
徐廷裸	徐	廷裸	士敏
趙莘	趙	莘	師尹
謝廷傑 	謝	廷傑 	宗聖
李輔	李	輔	子卿
龐瀾	龐	瀾	觀吾
李琦	李	琦	伯玉
蔡悉	蔡	悉	士皆
劉介齡	劉	介齡	少脩
張檟	張	檟	叔養
戴鳳翔	戴	鳳翔	志曾
吳教傳	吳	教傳	汝範
翟台	翟	台	思平
楊津	楊	津	汝問
程鳴伊	程	鳴伊	希正
梁梧	梁	梧	鳳鳴
邢邦	邢	邦	維翰
蔣凌漢	蔣	凌漢	節甫
詹彬	詹	彬	汝宜
熊秉元	熊	秉元	仁卿
丘達道	丘	達道	和仲
平康裕	平	康裕	德遠
孫汝翼	孫	汝翼	舜臣
王楫	王	楫	熙甫
張齊	張	齊	子修
顧廷對	顧	廷對	子俞
朱擢	朱	擢	登庸
吳于詩	吳	于詩	以興
賈淇	賈	淇	希武
尹約	尹	約	一之
周鳴塤	周	鳴塤	思友
郁言	郁	言	從忠
黃儀	黃	儀	象卿
趙訥	趙	訥	孟敏
張希稷	張	希稷	于田
洪有第	洪	有第	懋學
孫光祖	孫	光祖	子紹
馮珊	馮	珊	仲鳴
鄭惟僑	鄭	惟僑	子愛
高大化	高	大化	少賢
鮑宗沂	鮑	宗沂	志同
甄津	甄	津	汝問
夏永	夏	永	吉甫
孫代	孫	代	紹甫
周美	周	美	子充
李向陽	李	向陽	忠卿
羅大玘	羅	大玘	惟節
高甲	高	甲	一卿
雷以仁 	雷	以仁 	育卿
雷孔文 	雷	孔文 	質卿
楊樞	楊	樞	運卿
王廷瞻	王	廷瞻	稚表
李承嗣	李	承嗣	貞立
張庸	張	庸	子登
侯峩	侯	峩	子謙
張縉	張	縉	子忠
侯必登	侯	必登	懋學
劉南金	劉	南金	獻卿
張振之	張	振之	仲起
張蘊道	張	蘊道	君聘
郭大綸 	郭	大綸 	子理
周弘祖	周	弘祖	元孝
馬文學	馬	文學	行先
吳逢春	吳	逢春	子沐
胡儒	胡	儒	叔醇
段朝宗	段	朝宗	于海
張詡	張	詡	元卿
徐時行	徐	時行	汝默
王錫爵	王	錫爵	元馭
余有丁	余	有丁	丙仲
戚元佐	戚	元佐	希仲
項鈳	項	鈳	秉容
潘元端	潘	元端	仲履
佘立	佘	立	季禮
張廷臣	張	廷臣	伯鄰
陳洙	陳	洙	伯訓
郭文和	郭	文和	有臣
朱潤身	朱	潤身	德光
徐作	徐	作	汝念
鄭惇典	鄭	惇典	君勑
蔡一楠	蔡	一楠	廷用
李材	李	材	孟誠
楊俊民	楊	俊民	伯章
傅霖	傅	霖	應期
吳善	吳	善	元夫
萬廷言	萬	廷言	曰忠
徐用檢	徐	用檢	克賢
王宜	王	宜	時行
葉以蕃	葉	以蕃	承叔
徐元氣	徐	元氣	汝和
陳大章	陳	大章	祖堯
闞繼禹	闞	繼禹	叔敬
鍾振	鍾	振	玉甫
董原道	董	原道	性之
沈玄華	沈	玄華	瑞伯
史檟	史	檟	子美
林烴	林	烴	貞耀
王廷輔	王	廷輔	良卿
劉經緯	劉	經緯	道甫
楊世華	楊	世華	懋成
蘇愚	蘇	愚	君明
許寧遠	許	寧遠	孟中
陳學曾	陳	學曾	汝魯
曾璠	曾	璠	子玉
曹子登	曹	子登	以漸
馮敏功	馮	敏功	元卿
王同讚	王	同讚	儆甫
項思教	項	思教	敬敷
周浩	周	浩	養正
呂藿	呂	藿	忱卿
成鍾音	成	鍾音	本諧
陳有年	陳	有年	登之
張允濟	張	允濟	愛甫
王錫命	王	錫命	天予
馬顧澤	馬	顧澤	晬卿
史詡	史	詡	克敏
陳學伊	陳	學伊	爾聘
林喬相	林	喬相	廷翰
蔡可賢	蔡	可賢	子齊
吳焯	吳	焯	純伯
賈應元	賈	應元	仁甫
陳燁	陳	燁	光宇
徐栢	徐	栢	守卿
李汶	李	汶	宗齊
徐學古	徐	學古	有獲
洪忻	洪	忻	守慶
王續之	王	續之	大卿
費堯年	費	堯年	熙之
郭棐	郭	棐	篤周
葉士賓	葉	士賓	尚賓
丁應璧	丁	應璧	為章
楊汝允	楊	汝允	惟明
周禧	周	禧	以吉
諸察	諸	察	子潛
王俸	王	俸	廉甫
張大忠	張	大忠	國楨
游季勳	游	季勳	懋甫
朱應時	朱	應時	子中
孫應元	孫	應元	仁甫
楊柟	楊	柟	仲木
張九歌	張	九歌	仲宜
陳俊	陳	俊	彥吾
吳孔性	吳	孔性	粹卿
梁綱	梁	綱	立夫
孫坤	孫	坤	順夫
劉浡	劉	浡	自裕
張希召	張	希召	于南
陳賢	陳	賢	子及
呂一靜	呂	一靜	子正
俞南金	俞	南金	國良
徐廷授	徐	廷授	受之
萬振孫	萬	振孫	性孺
隗邦衡	隗	邦衡	志伊
項萬壽	項	萬壽	子信
段孟賢	段	孟賢	汝愚
蔡叔逵	蔡	叔逵	于漸
杜輅	杜	輅	從殷
王乾章	王	乾章	順卿
張崇倫	張	崇倫	子常
蒙詔	蒙	詔	廷綸
張從律	張	從律	懋和
戴濂	戴	濂	希茂
吉大同	吉	大同	伯從
徐一忠	徐	一忠	宗顯
沈廷觀	沈	廷觀	賓卿
崔鏞	崔	鏞	汝洪
李臺	李	臺	君佐
王楨	王	楨	宗彥
卜相	卜	相	夢良
艾杞	艾	杞	子徵
王謨	王	謨	體文
吳維京	吳	維京	樞季
劉之蒙	劉	之蒙	淑正
吳一琴	吳	一琴	子清
范愛眾	范	愛眾	同人
孫以仁	孫	以仁	學元
袁三接	袁	三接	邦表
陳烈	陳	烈	思紹
王同道	王	同道	純甫
李惟觀	李	惟觀	動可
嚴鎡	嚴	鎡	應時
馬會	馬	會	元明
郭良	郭	良	復吾
吳一本	吳	一本	仲立
陳邦顏	陳	邦顏	獻祉
賈仁元	賈	仁元	子善
黃文煒	黃	文煒	德華
劉世曾	劉	世曾	胤甫
蕭守身	蕭	守身	尚本
秦崢	秦	崢	思謙
王宇	王	宇	子大
胡嘉謨	胡	嘉謨	子忠
蔣機	蔣	機	若衡
薛東海	薛	東海	汝觀
李學道	李	學道	汝致
辛應乾	辛	應乾	伯符
彭富	彭	富	中禮
王嘉祥	王	嘉祥	兆興
田成法	田	成法	子憲
薛德統	薛	德統	守正
舒應龍	舒	應龍	時見
劉早	劉	早	思舜
張鎛	張	鎛	伯始
鄒廷望	鄒	廷望	道吾
陳頤正	陳	頤正	觀甫
劉珮	劉	珮	象德
李鶚	李	鶚	凌秋
楊成名	楊	成名	志完
趙應元	趙	應元	子貞
劉翾	劉	翾	惟翰
李寅賓	李	寅賓	于暘
周詠	周	詠	思養
王宗載	王	宗載	時厚
陳三綱	陳	三綱	振道
劉仕階	劉	仕階	以學
王汝梅	王	汝梅	德和
陳楠	陳	楠	子林
楊文明	楊	文明	仲謨
劉泮	劉	泮	汝化
王嘉言	王	嘉言	君謨
王原相	王	原相	召之
趙睿	趙	睿	若思
蔣致大	蔣	致大	汝為
錢貢	錢	貢	時庸
戚于國	戚	于國	忠甫
艾可久	艾	可久	德徵
林梓	林	梓	汝材
王澤	王	澤	子仁
王以纁	王	以纁	伯聘
蔚元康	蔚	元康	良甫
曹當勉	曹	當勉	可賢
王時舉	王	時舉	晉卿
劉寅	劉	寅	宗夏
羅晉寶	羅	晉寶	子虛
任維鏜	任	維鏜	子揚
王納言	王	納言	舜卿
李承緒	李	承緒	伯餘
盛時選	盛	時選	以仁
皮汝謙	皮	汝謙	子揚
丁誠	丁	誠	子成
祝尚義	祝	尚義	質甫
柴宗義	柴	宗義	子集
郜永春	郜	永春	子元
蹇達	蹇	達	汝上
段繡	段	繡	弘憲
劉田	劉	田	仲龍
侯思古	侯	思古	士睿
王篆	王	篆	汝文
黃學海	黃	學海	宗于
郭夢得	郭	夢得	甫卿
胡價	胡	價	士重
史文龍	史	文龍	應霖
莫天賦	莫	天賦	子翼
喬應春	喬	應春	仁卿
王學古	王	學古	子獲
張璇	張	璇	伯祥
李復聘	李	復聘	守珍
李橡	李	橡	孟栗
宗弘暹	宗	弘暹	晉甫
鮑尚伊	鮑	尚伊	子任
華啟直	華	啟直	禮成
陳應春	陳	應春	有暉
席上珎	席	上珎	待聘
殷登瀛	殷	登瀛	子登
任春元	任	春元	長卿
鄭欽	鄭	欽	堯卿
吳從憲	吳	從憲	惟時
朱朋求	朱	朋求	道元
王爕	王	爕	大裡
張國謙	張	國謙	爾光
周世選	周	世選	文賢
栗祁	栗	祁	子登
龍光	龍	光	國華
宋守約	宋	守約	崇要
劉時秋	劉	時秋	義甫
孫光祜	孫	光祜	仲篤
周標	周	標	以升
陳謨	陳	謨	子嘉
趙可鎔	趙	可鎔	汝從
周宷	周	宷	濟甫
丘承祖	丘	承祖	克紹
張國彥	張	國彥	熙載
翟繡裳	翟	繡裳	汝衷
黃思近	黃	思近	與仁
陳文謨	陳	文謨	顯卿
鍾繼元	鍾	繼元	仁卿
程文著	程	文著	美中
陳希文	陳	希文	宗周
武尚賢	武	尚賢	君進
李可久	李	可久	之德
蕭大亨	蕭	大亨	夏卿
王叔杲	王	叔杲	陽德
王承芳	王	承芳	克濟
李苘	李	苘	子藎
雷大壯	雷	大壯	欽履
朱崇道	朱	崇道	惟正
吳鎮	吳	鎮	子靜
李學思	李	學思	充道
李崧	李	崧	應嶽
王之垣	王	之垣	爾式
楊子實	楊	子實	中孚
李貞元	李	貞元	淳甫
居希旦	居	希旦	汝魯
郭諫臣	郭	諫臣	子忠
李畿嗣	李	畿嗣	明卿
滕伯輪	滕	伯輪	汝載
潘民模	潘	民模	子傚
單訥	單	訥	希仁
陳于階	陳	于階	允升
廖際可	廖	際可	以禮
莊國禎	莊	國禎	君祉
陳憲	陳	憲	希原
李與善	李	與善	伯從
謝表	謝	表	子陳
王廷簡	王	廷簡	汝迪
陳大壯	陳	大壯	思立
李勳	李	勳	世臣
張應福	張	應福	子承
鍾崇文	鍾	崇文	仲謨
饒仁侃	饒	仁侃	近剛
楊愈茂	楊	愈茂	伯榮
鍾穀	鍾	穀	心卿
牛應龍	牛	應龍	時見
陳廷芝	陳	廷芝	季馨
張𡹮	張	𡹮	子靜
朱泰	朱	泰	良甫
丘騰	丘	騰	子雲
譚啟	譚	啟	繼之
周思充	周	思充	道可
劉繼文	劉	繼文	永謨
張守中	張	守中	叔原
鄧宗孔	鄧	宗孔	惟時
齊康	齊	康	太和
張應治	張	應治	體徵
凌琯	凌	琯	惟和
趙岩	趙	岩	維石
張問明	張	問明	子明
仇炅	仇	炅	文綗
王嘉賓	王	嘉賓	國光
王問臣	王	問臣	正叔
馬文煒	馬	文煒	仲韜
唐鍊	唐	鍊	純之
許文琦	許	文琦	大正
徐尚	徐	尚	志伯
馬明謨	馬	明謨	君獻
郭崇嗣	郭	崇嗣	承芳
李松	李	松	子節
倫文	倫	文	紹周
馬近奎	馬	近奎	文徵
高則益	高	則益	汝謙
孫振宗	孫	振宗	德聲
徐養大	徐	養大	子立
趙體敬	趙	體敬	克禮
彭範	彭	範	士洪
吳自峒	吳	自峒	伯高
傅文藻	傅	文藻	宗理
任汝亮	任	汝亮	伯寅
鄭履淳	鄭	履淳	叔初
李師孔	李	師孔	子肖
穆文熙	穆	文熙	敬甫
周以敬	周	以敬	用涵
陳文燧	陳	文燧	汝相
魏汝翼	魏	汝翼	子行
王輦	王	輦	子侍
吳善言	吳	善言	子遠
何文維	何	文維	衛正
范應期	范	應期	伯楨
李自華	李	自華	元實
陳棟	陳	棟	隆之
徐雲程	徐	雲程	允登
伊在庭	伊	在庭	繼美
鄒國儒	鄒	國儒	醇甫
宋諾	宋	諾	子重
馮子京	馮	子京	仲元
涂淵	涂	淵	時躍
陳經邦	陳	經邦	公望
屠元沐	屠	元沐	日新
周鐸	周	鐸	子振
林梓	林	梓	達材
湯希閔	湯	希閔	惟賢
李一迪	李	一迪	君哲
葉朝陽	葉	朝陽	文榮
潘志伊	潘	志伊	嘉徵
王嘉言	王	嘉言	孔彰
李汝節	李	汝節	道亨
王鑑	王	鑑	汝明
潘頤龍	潘	頤龍	躍卿
廖如春	廖	如春	韶景
宋應昌	宋	應昌	時祥
王基	王	基	啟亨
劉自化	劉	自化	伯時
李存文	李	存文	應魁
胡同文	胡	同文	子尚
周子義	周	子義	以方
錢立	錢	立	守禮
顧應龍	顧	應龍	汝翼
袁尊尼	袁	尊尼	魯望
王楣	王	楣	光大
梅友松	梅	友松	茂卿
安嘉善	安	嘉善	體亨
焦子春	焦	子春	德元
張思忠	張	思忠	子貞
陳懿德	陳	懿德	伯求
林雲程	林	雲程	登卿
陳王道	陳	王道	敬甫
林烋	林	烋	裕甫
丘雲章	丘	雲章	伯卿
劉志業	劉	志業	可大
甯鈳	甯	鈳	大受
楊時喬	楊	時喬	宜遷
邵元哲	邵	元哲	晦之
范伋	范	伋	汝希
顧養謙	顧	養謙	益卿
張明正	張	明正	大中
顧褒	顧	褒	惟忠
韓楫	韓	楫	伯通
劉光	劉	光	子晉
陳行健	陳	行健	體乾
熊養中	熊	養中	中甫
盛居	盛	居	康侯
許評	許	評	公甫
楊珂	楊	珂	士佩
楊惟喬	楊	惟喬	幼植
王子蕙	王	子蕙	樂秋
徐汝翼	徐	汝翼	君羽
王軒	王	軒	臨卿
胥遇	胥	遇	于巷
陳誥	陳	誥	守巽
戴大禮	戴	大禮	子雍
胡心得	胡	心得	元靜
梁策	梁	策	對之
游應乾	游	應乾	順之
霍維藎	霍	維藎	愛夫
何洛文	何	洛文	啟圖
林如楚	林	如楚	道翹
賴庭檜	賴	庭檜	而舟
施觀民	施	觀民	于我
陶大順	陶	大順	景熙
黃才敏	黃	才敏	爾懋
戴洵	戴	洵	汝誠
張純	張	純	碩恒
吳學詩	吳	學詩	伯興
喬懋敬	喬	懋敬	允德
徐時可	徐	時可	惟易
林有源	林	有源	育初
唐維城	唐	維城	邦翰
盛當時	盛	當時	明輔
袁國寧	袁	國寧	子清
沈鯉	沈	鯉	仲化
涂夢桂	涂	夢桂	時芳
姚光泮	姚	光泮	繼昭
蔣勸能	蔣	勸能	汝才
樊世緒	樊	世緒	子述
張秩	張	秩	以敬
李世臣	李	世臣	汝賢
唐一麐	唐	一麐	仁甫
陳文煥	陳	文煥	汝昭
宋良佐	宋	良佐	守忠
陸萬鍾	陸	萬鍾	元量
許大亨	許	大亨	貞甫
余希周	余	希周	思兼
許守謙	許	守謙	子受
丘浙	丘	浙	子東
萬言策	萬	言策	廷陳
楊允中	楊	允中	祖堯
胡邦奇	胡	邦奇	君才
晏仕翹	晏	仕翹	應望
鄭恭	鄭	恭	篤卿
王三錫	王	三錫	懷國
光懋	光	懋	子英
張孟男	張	孟男	元□
王執禮	王	執禮	子敬
葉逢春	葉	逢春	叔仁
崔行可	崔	行可	仕甫
金鉉	金	鉉	邦鼎
蔡廷臣	蔡	廷臣	藎臣
随府	随	府	子修
趙奮	趙	奮	庸卿
瞿𦒎	瞿	𦒎	鳳𦒎
鍾繼英	鍾	繼英	樂華
方九功	方	九功	允治
林偕春	林	偕春	孚元
周良臣	周	良臣	相聖
侯居艮	侯	居艮	伯成
趙應元	趙	應元	文宗
周大烈	周	大烈	元佐
嚴汝麟	嚴	汝麟	子仁
宋之韓	宋	之韓	元卿
陳王道	陳	王道	孟甫
魏體明	魏	體明	用晦
李大瀾	李	大瀾	觀甫
徐子器	徐	子器	實卿
王象坤	王	象坤	子厚
祝教	祝	教	子敷
蘇士潤	蘇	士潤	惟德
劉堯卿	劉	堯卿	宗舜
蘇民牧	蘇	民牧	乃徯
周繼	周	繼	善卿
聶廷璧	聶	廷璧	祖雍
李志學	李	志學	聖初
詹仰庇	詹	仰庇	汝欽
管大勳	管	大勳	世臣
張道	張	道	以中
楊家相	楊	家相	君卿
温純	温	純	淑文
徐維楫	徐	維楫	汝進
佘嘉詔	佘	嘉詔	彥綸
姚繼可	姚	繼可	光父
丁應賓	丁	應賓	聘之
舒鰲	舒	鰲	子化
董汝漢	董	汝漢	昭夫
趙慎修	趙	慎修	敬思
潘允哲	潘	允哲	伯明
覃應元	覃	應元	德芳
趙焞	趙	焞	子明
熊子臣	熊	子臣	國仕
徐元太	徐	元太	汝賢
李芳	李	芳	叔承
馮汝騏	馮	汝騏	仁卿
韓應元	韓	應元	雲卿
陳法	陳	法	萃章
熊煒	熊	煒	天奎
丁惟寧	丁	惟寧	養靜
王璽	王	璽	予信
龔以正	龔	以正	德禎
向程	向	程	宗洛
沈淵	沈	淵	子靜
蔣夢龍	蔣	夢龍	子徵
許鎡	許	鎡	國器
岳維華	岳	維華	汝西
許公大	許	公大	德謙
許天贈	許	天贈	德夫
楊可大	楊	可大	業甫
范崙	范	崙	子大
王弘誨	王	弘誨	紹傳
王淑陵	王	淑陵	之義
趙宦	趙	宦	文光
張博	張	博	子約
楊沐	楊	沐	子新
張一通	張	一通	汝達
程實	程	實	時彰
謝師嚴	謝	師嚴	汝心
張鳳徵	張	鳳徵	舜夫
李栻	李	栻	孟敬
王貽德	王	貽德	師禹
李之珍	李	之珍	席卿
陳文燭	陳	文燭	玉叔
金昭	金	昭	懋卿
潘仲徽	潘	仲徽	克典
鄭一信	鄭	一信	君允
魏屏山	魏	屏山	民望
駱問禮	駱	問禮	子本
陶允淳	陶	允淳	懋初
許國	許	國	維楨
李充實	李	充實	中虛
吳文佳	吳	文佳	士望
王湘	王	湘	大清
林樹德	林	樹德	與成
錢錫汝	錢	錫汝	寵伯
沈楩	沈	楩	材叔
李鳴謙	李	鳴謙	得卿
孟學易	孟	學易	與時
侯于趙	侯	于趙	宗度
呂子桂	呂	子桂	公攀
傅孟春	傅	孟春	體元
侯居坤	侯	居坤	伯生
鄭傑	鄭	傑	汝興
賀一桂	賀	一桂	秋芳
匡鐸	匡	鐸	淑教
楊松	楊	松	惟喬
陳錡	陳	錡	公鼎
胡涍	胡	涍	原荊
李良臣	李	良臣	直甫
李日強	李	日強	元莊
王元賓	王	元賓	國賢
董三遷	董	三遷	汝孟
徐執策	徐	執策	以獻
成憲	成	憲	君廸
葉夢熊	葉	夢熊	男兆
徐儒	徐	儒	邦珍
曹慎	曹	慎	思永
張德夫	張	德夫	子成
季膺	季	膺	元服
易可久	易	可久	德夕即
張煥	張	煥	懋文
陳可大	陳	可大	德周
李貴和	李	貴和	子中
歸有光	歸	有光	熙甫
傅寵	傅	寵	君錫
楊鎔	楊	鎔	德夫
黃茂	黃	茂	叔才
李澤	李	澤	文孚
王以修	王	以修	敬甫
姜忻	姜	忻	克榮
李得陽	李	得陽	伯英
王圻	王	圻	元翰
盧漸	盧	漸	□貞
魏澧	魏	澧	汝衡
熊汝器	熊	汝器	國用
楊守仁	楊	守仁	嘉復
張學顏	張	學顏	子的
鄷一相	鄷	一相	輔之
李學詩	李	學詩	子興
張應登	張	應登	仲庸
蕭復陽	蕭	復陽	道長
劉伯生	劉	伯生	寓愛
桂天祥	桂	天祥	子興
崔廷試	崔	廷試	文卿
臧惟一	臧	惟一	守中
李學詩	李	學詩	叔言
陳栢	陳	栢	子秀
郭庭梧	郭	庭梧	子材
楊相	楊	相	允立
林紹	林	紹	文肖
李文餘	李	文餘	廷積
居守	居	守	子約
烏昇	烏	昇	顯卿
高啟愚	高	啟愚	敏甫
盧明章	盧	明章	用晦
蔣思孝	蔣	思孝	移之
楊一魁	楊	一魁	子選
查鐸	查	鐸	子警
許乾	許	乾	伯貞
吳與言	吳	與言	志說
章甫端	章	甫端	子相
王謠	王	謠	民皥
李薦佳	李	薦佳	伯受
陳三謨	陳	三謨	汝明
張克家	張	克家	有光
丘齊雲	丘	齊雲	汝謙
朱光宇	朱	光宇	德明
萬幾	萬	幾	汝思
錢楷	錢	楷	範之
周守愚	周	守愚	聖持
許希孟	許	希孟	師孔
楊一桂	楊	一桂	文芳
傅良諌	傅	良諌	以信
李謨	李	謨	顯卿
陳惟直	陳	惟直	伯生
朱學顏	朱	學顏	子愚
鄭繼之	鄭	繼之	伯孝
趙可懷	趙	可懷	德仲
馬三樂	馬	三樂	克性
李應蘭	李	應蘭	芳卿
羅惟垣	羅	惟垣	少辰
古之賢	古	之賢	士希
李巳	李	巳	子復
李采菲	李	采菲	君采
笪東光	笪	東光	景陽
包乾	包	乾	元夫
計謙亨	計	謙亨	光甫
朱一松	朱	一松	應秀
鄭昊	鄭	昊	祖欽
閻漳	閻	漳	汝清
顧綬	顧	綬	子印
鄭金	鄭	金	伯純
杜友蘭	杜	友蘭	化卿
余一龍	余	一龍	汝化
申維岱	申	維岱	國鎮
金應徵	金	應徵	懋德
趙應龍	趙	應龍	時化
俞一貫	俞	一貫	原道
蕭敏道	蕭	敏道	曰遜
殷渠	殷	渠	伯清
左熈	左	熈	夏伯
龔廷璧	龔	廷璧	若純
陳吾德	陳	吾德	懋修
胡文燿	胡	文燿	其暐
蒲凝重	蒲	凝重	鎮之
宋豸	宋	豸	思直
陳一龍	陳	一龍	見甫
鄭宣化	鄭	宣化	行義
馬應夢	馬	應夢	仕徵
張守約	張	守約	希曾
常存仁	常	存仁	靜甫
陸士鰲	陸	士鰲	巨卿
董石	董	石	叔玉
陳思育	陳	思育	子錫
王應吉	王	應吉	伯修
張體乾	張	體乾	惟健
劉良弼	劉	良弼	賚卿
林元立	林	元立	宗介
劉易從	劉	易從	簡之
張孔脩	張	孔脩	允治
陳宣	陳	宣	汝化
何子明	何	子明	汝晦
蕭廩	蕭	廩	可發
紀大綱	紀	大綱	允立
薛鑰	薛	鑰	希準
張更化	張	更化	德孚
胡效才	胡	效才	用甫
朱潤	朱	潤	天澤
劉渾成	劉	渾成	廉卿
許僴	許	僴	文夫
雒遵	雒	遵	道行
李冲奎	李	冲奎	拱北
張崇功	張	崇功	惟志
戚杰	戚	杰	世秀
丁懋儒	丁	懋儒	聘卿
張磐	張	磐	鴻漸
禇鈇	禇	鈇	民威
戴延容	戴	延容	子涵
曾如春	曾	如春	仁祥
杜其萌	杜	其萌	于先
王家卿	王	家卿	應忠
程文	程	文	載道
劉世亨	劉	世亨	以進
薛志義	薛	志義	民服
王三鍚	王	三鍚	用懷
李思寅	李	思寅	子衷
鄧林喬	鄧	林喬	子楨
王用章	王	用章	汝平
林世章	林	世章	尚闇
秦吉士	秦	吉士	子敬
梁子綺	梁	子綺	汝珍
許光大	許	光大	子乾
嚴用和	嚴	用和	禮衡
羅名士	羅	名士	以旂
賈舘	賈	舘	子業
李邦佐	李	邦佐	治卿
張瀾	張	瀾	行仲
歐希稷	歐	希稷	子文
王朝陽	王	朝陽	仰明
鄭遇春	鄭	遇春	子復
吳道明	吳	道明	行甫
周希畢	周	希畢	德懋
魏勲	魏	勲	世卿
王庭詩	王	庭詩	言卿
池浴德	池	浴德	仕爵
周良賔	周	良賔	以尚
蕭遍	蕭	遍	文明
竇如蘭	竇	如蘭	子化
汪文輝	汪	文輝	德充
陳鴻猷	陳	鴻猷	用忠
沈伯龍	沈	伯龍	雲卿
李溥	李	溥	公甫
岳凌霜	岳	凌霜	子肅
暴孟竒	暴	孟竒	純甫
王之屏	王	之屏	汝藩
呂若愚	呂	若愚	可明
施愛	施	愛	欲周
李純朴	李	純朴	文伯
龔	龔		方來
周芸	周	芸	用馨
何玉德	何	玉德	彥貴
梁問孟	梁	問孟	尚賢
劉自存	劉	自存	體心
杜化中	杜	化中	民孚
孫濟遠	孫	濟遠	承澤
趙思誠	趙	思誠	汝孝
麻永吉	麻	永吉	伯貞
戢汝止	戢	汝止	敬之
孫維清	孫	維清	仲直
陳應薦	陳	應薦	惟賢
戴記	戴	記	儀周
邵廉	邵	廉	虛直
高克謙	高	克謙	廷益
張燆	張	燆	子行
王一治	王	一治	子雍
王肇林	王	肇林	梅芳
羅萬化	羅	萬化	一甫
黃鳳翔	黃	鳳翔	鳴周
趙志臯	趙	志臯	汝邁
李長春	李	長春	元甫
王家屏 	王	家屏 	忠伯
田一儁	田	一儁	賓陽
李逢陽	李	逢陽	惟明
王周紹	王	周紹	仲孝
張孟觀	張	孟觀	輝賓
陳于陛	陳	于陛	元忠
胡來貢	胡	來貢	從治
王鼎爵	王	鼎爵	家馭
金學曾	金	學曾	子魯
華叔陽	華	叔陽	起龍
朱孟震	朱	孟震	秉器
紀五常	紀	五常	一元
宋堯武	宋	堯武	季鷹
葉九金	葉	九金	廷相
徐顯卿	徐	顯卿	公望
張世烈	張	世烈	丕楊
殷建中	殷	建中	子道
施夢龍	施	夢龍	伯雨
邵陛	邵	陛	世忠
陸萬垓	陸	萬垓	天溥
許應逵	許	應逵	伯漸
洪邦光	洪	邦光	世龍
李維楨	李	維楨	本寍
趙來亨	趙	來亨	修甫
喬因阜	喬	因阜	思棉
喬木	喬	木	伯梁
姚宗堯	姚	宗堯	守一
陳允升	陳	允升	晉卿
李文簡	李	文簡	志可
張位	張	位	明成
張大器	張	大器	尚通
江以東	江	以東	貞伯
江圻	江	圻	子望
方沆	方	沆	子及
陳王道	陳	王道	子敬
施近臣	施	近臣	晉甫
袁一虬	袁	一虬	汝化
韓世能	韓	世能	存良
郝汝松	郝	汝松	茂甫
屠謙	屠	謙	子益
王繼祖	王	繼祖	克紹
黃焯	黃	焯	原靜
李伯芳	李	伯芳	廷實
李熙	李	熙	穆之
馮孜	馮	孜	子漸
王汝魯	王	汝魯	希曾
林景暘	林	景暘	紹熙
甘來學	甘	來學	開之
唐可封	唐	可封	隆臣
張一桂	張	一桂	庭芳
鄭汝璧	鄭	汝璧	邦章
胡養正	胡	養正	繼功
沈藻	沈	藻	元明
周啟祥	周	啟祥	源伯
徐應奎	徐	應奎	汝祥
王體復 	王	體復 	陽父
顧顯仁	顧	顯仁	元伯
劉葵	劉	葵	効忠
汪審 	汪	審 	惟幾
于慎行	于	慎行	可遠
陳澗	陳	澗	汝新
沈懋孝	沈	懋孝	幼真
王之士	王	之士	吉甫
陳九仭	陳	九仭	爾進
王懋德	王	懋德	敏中
蘇民望	蘇	民望	子惠
葉明元	葉	明元	弼虞
吳自新 	吳	自新 	伯恒
劉伯爕	劉	伯爕	元甫
蔡文範	蔡	文範	道華
胡緒	胡	緒	本理
吳肇東	吳	肇東	守初
焦玄鑑	焦	玄鑑	仲明
朱賡	朱	賡	少欽
傅時望	傅	時望	仲瞻
錢順德	錢	順德	道充
盧維禎	盧	維禎	司典
李頤	李	頤	惟貞
栗在庭	栗	在庭	應鳳
馮時雨	馮	時雨	化之
江廷寄	江	廷寄	時任
劉體道	劉	體道	親正
鄭遷	鄭	遷	孟喬
來經濟	來	經濟	濟時
辛如金	辛	如金	汝礪
張偲	張	偲	士忠
須用賓	須	用賓	國卿
王任重	王	任重	世卿
羅璧	羅	璧	伯現
鍾庚陽	鍾	庚陽	長卿
侯世卿	侯	世卿	國輔
周于德	周	于德	貞吉
李廷益	李	廷益	在謙
周繼夏	周	繼夏	以亨
錢普 	錢	普 	以德
張堯年	張	堯年	長卿
劉世賞	劉	世賞	功甫
劉應麒	劉	應麒	道徵
劉登庸	劉	登庸	行可
陳堂	陳	堂	明佐
敖鯤	敖	鯤	化甫
蔡汝賢	蔡	汝賢	用卿
聶良杞	聶	良杞	汝實
陳昌言	陳	昌言	仲俞
劉庚	劉	庚	公恒
唐裔	唐	裔	世卿
田子堅	田	子堅	茂甫
蔣遵箴	蔣	遵箴	淑四
龔勉	龔	勉	子勤
李尚思	李	尚思	從學
林敬冕	林	敬冕	紹周
李陽春	李	陽春	時化
張嵿	張	嵿	子謙
陳所敏	陳	所敏	吾達
張崶	張	崶	汝登
鄭岳	鄭	岳	永翰
胡峻德	胡	峻德	明卿
張楚城	張	楚城	釐卿
李一本 	李	一本 	汝培
張克文 	張	克文 	宗質
薛綸	薛	綸	汝為
邵一本	邵	一本	志道
陳萬言	陳	萬言	汝嘉
梁許	梁	許	君可
高時	高	時	師孔
祝世喬	祝	世喬	子遷
傅性敏	傅	性敏	惟學
史思敬	史	思敬	直卿
韋以誠	韋	以誠	立夫
賈應璧	賈	應璧	文宿
唐邦佐	唐	邦佐	惟良
沈一貫	沈	一貫	肩吾
張正道	張	正道	可守
王應辰	王	應辰	瞻極
高世雨	高	世雨	元化
徐應聘	徐	應聘	任卿
楊道會	楊	道會	惟宗
賈三近	賈	三近	德脩
趙三聘	趙	三聘	天民
沈思孝	沈	思孝	純甫
吳道邇	吳	道邇	學平
馬千乘	馬	千乘	國良
徐成位	徐	成位	惟得
劉應望	劉	應望	思儼
萬鍾祿	萬	鍾祿	天錫
馮子履	馮	子履	禮甫
羅良禎	羅	良禎	應泰
劉東星	劉	東星	子明
魏仕賢	魏	仕賢	用可
李鎬	李	鎬	子京
楊時寧	楊	時寧	子安
戴燿	戴	燿	德輝
王京	王	京	來覲
許子良	許	子良	直夫
陳大猷	陳	大猷	鳴翊
張桐	張	桐	美夫
師道立	師	道立	惟心
鍾遐齡	鍾	遐齡	子宜
衛承芳	衛	承芳	君大
鄒墀	鄒	墀	朝卿
周思敬	周	思敬	子禮
李戴	李	戴	仁夫
袁魁	袁	魁	子鶚
黃一龍	黃	一龍	雲卿
穆煒	穆	煒	德輝
陳文衡	陳	文衡	惟平
張鏜	張	鏜	汝揚
蕭騰鳳	蕭	騰鳳	明仲
陳蕖	陳	蕖	伯舍
楊沂	楊	沂	子興
袁弘德	袁	弘德	執甫
任惟一	任	惟一	汝賢
賈待問	賈	待問	學叔
張元善	張	元善	道一
戴文宗	戴	文宗	時範
習孔教	習	孔教	時甫
徐學詩	徐	學詩	子言
左縉	左	縉	士卿
唐文燦	唐	文燦	若素
王用汲	王	用汲	明受
周易	周	易	尚占
徐秋鶚	徐	秋鶚	光祖
程拱宸	程	拱宸	仲星
蔡應科　	蔡	應科　	思盛
李燾	李	燾	若臨
徐大任	徐	大任	重夫
蔣希孔	蔣	希孔	以中
劉魯	劉	魯	希曾
景嵩	景	嵩	惟中
董邦禮	董	邦禮	希伯
王來召	王	來召	汝行
王土	王	土	曰衡
劉竟成	劉	竟成	志卿
鮑希顏	鮑	希顏	聞道
謝萬壽	謝	萬壽	應祝
熊瑞	熊	瑞	憲祥
劉浹	劉	浹	宗說
劉翲	劉	翲	于翰
馬伋	馬	伋	汝賢
楊歸儒	楊	歸儒	季中
尚芾	尚	芾	章甫
王之臣	王	之臣	藎夫
熊鎡	熊	鎡	仲時
湯聘尹　	湯	聘尹　	元衡
謝良琦　	謝	良琦　	景韓
張東暘	張	東暘	維寅
翁金堂	翁	金堂	升伯
鄭國仕	鄭	國仕	允升
呂宗儒	呂	宗儒	汝為
黃金色	黃	金色	鍊之
詹世用	詹	世用	汝賓
白希珩　	白	希珩　	汝佩
徐汝陽	徐	汝陽	時泰
袁桂蓁	袁	桂蓁	子美
秦舜翰	秦	舜翰	國宗
黃應坤	黃	應坤	惟簡
曹大埜	曹	大埜	仲平
張明化	張	明化	成甫
傅元順　	傅	元順　	伯達
蔡壁	蔡	壁	伯宿
劉紹恤	劉	紹恤	汝欽
蔡貴易	蔡	貴易	爾通
叢文蔚	叢	文蔚	豹卿
余乾貞	余	乾貞	秉智
李梧	李	梧	士仕
朱南雍	朱	南雍	子肅
党馨	党	馨	季芳
張淳	張	淳	希古
司汝霖	司	汝霖	澤民
許洛	許	洛	希程
張書	張	書	子中
詹貞吉	詹	貞吉	惟一
文作	文	作	述甫
程沂	程	沂	岱源
孫錝	孫	錝	文秉
郭四維	郭	四維	汝張
郭堵	郭	堵	季孝
孫從龍	孫	從龍	化光
張仲懽	張	仲懽	友卿
楊言	楊	言	行可
石檟	石	檟	伯材
解學禮	解	學禮	仲立
汪在前	汪	在前	立伯
梁承學	梁	承學	師顏
范謙	范	謙	汝益
于有年	于	有年	時秦
胡格誠	胡	格誠	中孚
王喬桂	王	喬桂	引瞻
孫化龍	孫	化龍	時際
李一中	李	一中	時卿
邵城	邵	城	惟衛
李春光	李	春光	輝甫
王詔	王	詔	承恩
王一鳳	王	一鳳	鳴文
顏容舒	顏	容舒	日莊
王宣化	王	宣化	用賢
劉朴	劉	朴	華甫
鄒學柱	鄒	學柱	國材
朱東光	朱	東光	元曦
謝良弼	謝	良弼	夢之
李學一	李	學一	萬卿
許承周	許	承周	公瑜
劉應雷	劉	應雷	汝豫
帥機	帥	機	惟審
宋伯華	宋	伯華	汝含
閻邦寍	閻	邦寍	仲謐
劉啟元	劉	啟元	乾初
田樂	田	樂	希智
黃卷	黃	卷	翰伯
史朝鉉	史	朝鉉	貫之
趙欽湯	趙	欽湯	子質
陳九疇	陳	九疇	惟敘
歐陽栢	歐陽	栢	惟承
蔣科	蔣	科	士登
李尚賓	李	尚賓	允興
姚孟賢	姚	孟賢	汝德
蔣桐	蔣	桐	子培
李國觀	李	國觀	次賓
胡用賓	胡	用賓	晉卿
張脩吉	張	脩吉	慎之
王琢玉	王	琢玉	文珍
王恩民	王	恩民	仁溥
周一經	周	一經	子明
陸從平	陸	從平	履素
王惟幾	王	惟幾	子研
高一登	高	一登	汝薦
詹洪基	詹	洪基	子震
劉維嵩	劉	維嵩	鎮中
房如式	房	如式	憲甫
余之禎	余	之禎	善先
沈應文	沈	應文	徵甫
王藻	王	藻	國華
郭莊	郭	莊	子蒞
陸志孝	陸	志孝	仁卿
魏雲霄	魏	雲霄	子冲
張道明	張	道明	行甫
張簡	張	簡	易從
陳祖堯	陳	祖堯	師欽
殷濡	殷	濡	子沾
葉楙中	葉	楙中	敬甫
王頤	王	頤	觀生
莊有臨	莊	有臨	際盛
余欽	余	欽	敬甫
蔣以忠	蔣	以忠	子孝
孫汝賓	孫	汝賓	允尚
李仕華	李	仕華	邦憲
王儼	王	儼	若思
周思稷	周	思稷	子相
李樂	李	樂	彥和
龔懋賢	龔	懋賢	晉甫
王大用	王	大用	擢之
于鯨	于	鯨	子長
徐元吉　	徐	元吉　	黃裳
謝宗倫　	謝	宗倫　	子敘
陳一夔	陳	一夔	樂卿
顧大典	顧	大典	道行
韓必顯　	韓	必顯　	用晦
陳尚伊	陳	尚伊	汝聘
曹昉	曹	昉	子明
劉伯縉	劉	伯縉	薦卿
紀克一	紀	克一	貞甫
劉不息	劉	不息	體道
闕成章	闕	成章	孔裁
張朝瑞	張	朝瑞	子禎
胡友信	胡	友信	成之
秦致恭	秦	致恭	率禮
裴應章	裴	應章	元闇
余懋學	余	懋學	行之
張孫繩	張	孫繩	公武
劉倬	劉	倬	原檢
李瑱	李	瑱	聰甫
張試	張	試	式言
史邦直	史	邦直	敬司
任芹	任	芹	汝獻
張道允	張	道允	叔學
杜其驕	杜	其驕	汝大
鄭準	鄭	準	正衡
辜明試	辜	明試	懋功
邵仲祿	邵	仲祿	孟廉
羅徵竹	羅	徵竹	庭猗
陳嚴之	陳	嚴之	泰仲
黃猷吉　	黃	猷吉　	仕禎
咸懷良	咸	懷良	廷遂
孫珮	孫	珮	伯玉
張弘毅	張	弘毅	士可
高自新	高	自新	本澄
趙惟卿	趙	惟卿	良弼
趙允升	趙	允升	吉夫
郭思極	郭	思極	致中
李尚默	李	尚默	子靜
周裔登	周	裔登	朝亮
顧梁材	顧	梁材	弘任
劉如臯	劉	如臯	德卿
趙雲翔　	趙	雲翔　	元舉
杜循	杜	循	伯理
王中逵	王	中逵	道卿
張士奇	張	士奇	子傑
李憙	李	憙	樂天
沈楠	沈	楠	汝材
劉守仁　	劉	守仁　	與居
羅奎	羅	奎	明漢
劉鉉	劉	鉉	玉卿
胡汝欽	胡	汝欽	子敬
耿鳴世	耿	鳴世	茂謙
沈位	沈	位	道立
毛圖南	毛	圖南	宇化
劉致中	劉	致中	位夫
秦時吉	秦	時吉	修之
劉光國　	劉	光國　	汝觀
周西	周	西	毓美
房寰	房	寰	中伯
周世科	周	世科	仲登
郝維喬	郝	維喬	子遷
梁式	梁	式	似之
謝廷敬	謝	廷敬	宗文
王一誠	王	一誠	明得
林華	林	華	原積
吳鑑	吳	鑑	順應
何世學	何	世學	文甫
易倣之	易	倣之	惟效
黃德洋	黃	德洋	以達
偰維賢	偰	維賢	佑之
牛可麟	牛	可麟	瑞卿
劉禹謨	劉	禹謨	平甫
黃家棟　	黃	家棟　	國隆
楊節	楊	節	子貞
方學孟	方	學孟	子醇
郭有金	郭	有金	雙南
萬一貫　	萬	一貫　	汝唯
趙時敏	趙	時敏	子遜
趙池	趙	池	道涵
曹銑	曹	銑	子良
沈文　	沈	文　	思質
何維椅	何	維椅	喬佐
章禮	章	禮	約之
孫汝匯	孫	汝匯	仲選
霍希夔	霍	希夔	虞卿
錢拱宸	錢	拱宸	恭卿
喻均	喻	均	邦相　
張元忭	張	元忭	子藎
劉瑊	劉	瑊	玉儔
鄧以讚	鄧	以讚	汝德
趙鵬程	趙	鵬程	汝圖
施策	施	策	懋揚
趙于敏	趙	于敏	訥甫
劉臺	劉	臺	國基
李際寅	李	際寅	賓甫
楊材	楊	材	楚良
陳詔	陳	詔	宣卿
耿定力	耿	定力	子徤
盛訥	盛	訥	敏叔
林一材	林	一材	以成
王懋德	王	懋德	敬甫
史鈳	史	鈳	汝和
黃洪憲	黃	洪憲	懋忠
曹時聘	曹	時聘	希尹
趙參魯	趙	參魯	宗傳
王來賢	王	來賢	元德
方揚	方	揚	思善
吳中行	吳	中行	子道
李盛春	李	盛春	淑元
錢若賡	錢	若賡	德咸
沈應科	沈	應科	邦彥
潘雲祥	潘	雲祥	瑞徵
李時英	李	時英	含之
陳以朝	陳	以朝	宗甫
諸夢環	諸	夢環	仲希
姚純臣	姚	純臣	熙載
袁昌祚	袁	昌祚	茂文
鄭邦福	鄭	邦福	洪疇
周嘉謨	周	嘉謨	明卿
任天祚	任	天祚	良錫
趙國璧	趙	國璧	子完
荊光裕	荊	光裕	孝啟
魏雷	魏	雷	子鳴
余良樞	余	良樞	士中
李登	李	登	瀛士
洪烝	洪	烝	惟進
吳思學	吳	思學	叔敏
趙範	趙	範	範之
李伯春	李	伯春	友卿
趙秉孜	趙	秉孜	恒守
裴賜	裴	賜	公受
張彥	張	彥	士美
杜搢	杜	搢	端叔
管志道	管	志道	登之
勞遜志	勞	遜志	惟敏
史繼志	史	繼志	思善
熊惟學	熊	惟學	習之
吳秀	吳	秀	越賢
楊士元	楊	士元	仁甫
薛亨	薛	亨	道行
甘一驥	甘	一驥	德夫
呂三才	呂	三才	自參
黃兆隆	黃	兆隆	懋德
周有光	周	有光	顯伯
夏良心	夏	良心	宗堯
劉虞夔	劉	虞夔	直卿
張登雲	張	登雲	攀龍
蕭良榦	蕭	良榦	以寧
霍鎮東	霍	鎮東	彥蕃
王世能	王	世能	子才
董用威	董	用威	愛先
商為正	商	為正	尚德
管稷	管	稷	子安
熊敦朴	熊	敦朴	茂初
李時達	李	時達	子行
王守誠	王	守誠	時化
莫與齊	莫	與齊	道望
楊佩訓	楊	佩訓	維式
施天麟	施	天麟	以德
王教	王	教	子脩
劉元震	劉	元震	衍亨
周思宸	周	思宸	進可
唐鶴徵	唐	鶴徵	玄卿
侯堯封	侯	堯封	欽之
鄒德涵	鄒	德涵	汝海
張鳴鶴	張	鳴鶴	于皋
公家臣	公	家臣	共父
金階	金	階	子升
周良寅	周	良寅	以衷
王應乾	王	應乾	調元
唐堯欽	唐	堯欽	寅可
王幼慈	王	幼慈	子依
郭子直	郭	子直	舜舉
王曉	王	曉	寅亮
葛登名	葛	登名	道行
李丁	李	丁	明甫
陳功	陳	功	惟志
江文沛	江	文沛	良雨
李選	李	選	維賢
王希元	王	希元	啟善
龍宗武	龍	宗武	身之
蕭彥	蕭	彥	思學
謝師啟	謝	師啟	叔蒙
葉時新	葉	時新	惟懷
陳薦	陳	薦	君庸
周光鎬	周	光鎬	國雍
王庭	王	庭	以覲
程正誼	程	正誼	叔明
章如鈺	章	如鈺	伯温
郭宗磐	郭	宗磐	漸甫
郭子章	郭	子章	相奎
吳道卿	吳	道卿	公輔
謝廷寀	謝	廷寀	思敬
陳大科	陳	大科	思進
趙用賢	趙	用賢	汝師
張程	張	程	以孚
錢岱	錢	岱	汝瞻
吳汝倫	吳	汝倫	文敘
虞懷忠	虞	懷忠	汝良
周保	周	保	子翼
諸大倫	諸	大倫	仁夫
尹良任	尹	良任	志伊
王緘	王	緘	伯黙
黎邦琰	黎	邦琰	君華
曾士楚	曾	士楚	子翹
雷嘉祥	雷	嘉祥	和卿
雙鳳鳴	雙	鳳鳴	維禎
胡宥	胡	宥	子仁
李忱	李	忱	誠甫
林庭植	林	庭植	槐卿
沈涵	沈	涵	維敬
莊鵬舉	莊	鵬舉	圖南
張第	張	第	汝登
丁賓	丁	賓	禮原
賀南儒	賀	南儒	懷珍
鄭時章	鄭	時章	文敘
林應訓	林	應訓	子啟
田琯	田	琯	希玉
陳賛	陳	賛	宗謨
徐一唯	徐	一唯	宗曾
李楨	李	楨	維卿
賀愈	賀	愈	子抑
陳長祚	陳	長祚	以介
袁應旂	袁	應旂	邦士
李時成	李	時成	惟中
劉尚志	劉	尚志	汝立
李實	李	實	若虛
張學道	張	學道	子愛
劉應元	劉	應元	子春
顧其志	顧	其志	太冲
費標	費	標	孟立
阮尚賓	阮	尚賓	君重
許一德	許	一德	子恒
王許之	王	許之	以忠
孫繼先	孫	繼先	胤甫
謝師彥	謝	師彥	叔美
喬巖	喬	巖	巽甫
齊世臣	齊	世臣	惟良
伍士望	伍	士望	景周
郭汝	郭	汝	子稱
張彛訓	張	彛訓	天叙
楊德	楊	德	本明
蘇湖	蘇	湖	望涯
劉克正	劉	克正	懋一
錢節用	錢	節用	以貞
林鵬飛	林	鵬飛	希翰
俞汝為	俞	汝為	元宣
孫維城	孫	維城	宗甫
邢玠	邢	玠	搢伯
張治真	張	治真	明遇
唐應元	唐	應元	子春
張維翰	張	維翰	邦楨
王嘉柔	王	嘉柔	惟則
高自治	高	自治	思勉
孫訓	孫	訓	廷揚
陳用賓	陳	用賓	道亨
金從洋	金	從洋	汝孝
汪彥冲	汪	彥冲	懋中
范鳴謙	范	鳴謙	貞夫
吳琯	吳	琯	邦爕
王延	王	延	子長
俞文達	俞	文達	行之
王汝訓	王	汝訓	師古
孫謀	孫	謀	子裕
許夢熊	許	夢熊	應男
黃克念	黃	克念	睿卿
祁鯨	祁	鯨	孟化
馮盛宗	馮	盛宗	時翰
許樂善	許	樂善	修之
張應元	張	應元	子貞
王淑民	王	淑民	民敬
鄭宗學	鄭	宗學	汝志
陳明經	陳	明經	則濟
王道成	王	道成	原恭
張翰才	張	翰才	育甫
杜伸	杜	伸	汝直
馮笏	馮	笏	正伯
謝師成	謝	師成	汝器
丁元復	丁	元復	見心
趙楫	趙	楫	汝進
秦燿	秦	燿	道明
王炳衡	王	炳衡	伯欽
王民順	王	民順	道服
周邦傑	周	邦傑	英甫
李大晉	李	大晉	伯康
賈如式	賈	如式	孝徵
倪湯	倪	湯	德遠
董裕	董	裕	惟益
趙九思	趙	九思	一誠
戴光啟	戴	光啟	仲升
尹廷俊	尹	廷俊	位甫
顧問	顧	問	汝備
帥祥	帥	祥	履卿
張一元	張	一元	鳴春
俞嘉言	俞	嘉言	彰甫
李廷儀	李	廷儀	國瞻
胡時化	胡	時化	惟權
張譽	張	譽	德徵
劉振基	劉	振基	克成
孫成名	孫	成名	登甫
許雲濤	許	雲濤	元靜
高薦	高	薦	子揚
朱璉	朱	璉	文卿
李宜春	李	宜春	叔芳
曹樓	曹	樓	世登
周裔先	周	裔先	朝采
李東	李	東	啟元
徐貞明	徐	貞明	伯繼
李梯	李	梯	子登
吳中立	吳	中立	公度
崔應麒	崔	應麒	獻可
翟廷楠	翟	廷楠	棟叔
伍睿	伍	睿	用思
馬魯卿	馬	魯卿	道傳
王蔚	王	蔚	國光
漆彬	漆	彬	中甫
武尚耕	武	尚耕	邦聘
鍾昌	鍾	昌	繼文
廖希元	廖	希元	伯才
張燭	張	燭	叔明
戴洪恩	戴	洪恩	子仁
傅應禎	傅	應禎	思善
袁實遂	袁	實遂	宗茂
陳子需	陳	子需	以孚
劉師魯	劉	師魯	仲唯
燕好爵	燕	好爵	脩夫
劉天衢	劉	天衢	一登
田疇	田	疇	汝治
王來聘	王	來聘	席珍
劉垓	劉	垓	達可
張孫振	張	孫振	公緒
吉可久	吉	可久	以德
王敬民	王	敬民	用司
張應雷	張	應雷	思豫
王雲鷺	王	雲鷺	翀孺
顧九思	顧	九思	與睿
李安仁	李	安仁	體元
趙日新	趙	日新	用甫
鄭秉厚	鄭	秉厚	子載
王良心	王	良心	性德
李大吉	李	大吉	九彰
茹宗舜	茹	宗舜	子孝
韓鎧	韓	鎧	德威
劉惠喬	劉	惠喬	應遷
羅應鶴	羅	應鶴	德鳴
趙卿	趙	卿	汝良
王一乾	王	一乾	元卿
魏良知	魏	良知	師堯
詹沂	詹	沂	浴之
徐鳴鶴	徐	鳴鶴	子齡
韓容	韓	容	可受
郗據德	郗	據德	守之
唐本堯	唐	本堯	世承
范梅	范	梅	元春
萬世德	萬	世德	伯脩
由禮門	由	禮門	中夫
金應照	金	應照	夢暘
胡其高	胡	其高	汝升
方亮工	方	亮工	季鄰
劉楚先	劉	楚先	子良
李淶	李	淶	源甫
連三元	連	三元	子先
羅星	羅	星	拱北
李貞	李	貞	元之
劉伯淵	劉	伯淵	靜之
劉守泰	劉	守泰	交甫
劉養充	劉	養充	以道
宋存德	宋	存德	惟一
鄭銳	鄭	銳	遜卿
趙舉廉	趙	舉廉	汝介
趙燿	趙	燿	文明
馮時可	馮	時可	敏卿
姚學閔	姚	學閔	汝孝
黃道年	黃	道年	延卿
曹司勳	曹	司勳	應麒
齊一經	齊	一經	訓汝
王祖嫡	王	祖嫡	胤昌
張綸	張	綸	子合
宋儒	宋	儒	醇夫
劉四科	劉	四科	希哲
申思科	申	思科	登甫
江沛然	江	沛然	應吾
張一鯤	張	一鯤	伯大
孟秋	孟	秋	子成
蕭崇業	蕭	崇業	允修
詹全覺	詹	全覺	克先
姜奇方	姜	奇方	孟頴
郝孔昭	郝	孔昭	起潛
凃杰	凃	杰	汝高
吳撝謙	吳	撝謙	汝則
余良楨	余	良楨	士翼
苗煥	苗	煥	爾章
趙善政	趙	善政	以德
安九域	安	九域	于統
江和	江	和	民貴
劉希孟	劉	希孟	醇甫
王胤祥	王	胤祥	邦瑞
段補	段	補	希仲
王象乾	王	象乾	子廓
王湘	王	湘	原楚
丁應詔	丁	應詔	國賓
王汝濂	王	汝濂	道源
張宏綱	張	宏綱	師正
徐一檟	徐	一檟	汝材
徐學禮	徐	學禮	子立
鄺彭齡	鄺	彭齡	幼玄
張惟誠	張	惟誠	汝思
邢鳳毛	邢	鳳毛	世美
鄭人逵	鄭	人逵	克漸
張正鵠	張	正鵠	道中
虞德燁	虞	德燁	光卿
鐵篆	鐵	篆	維信
冉夢松	冉	夢松	貴卿
尹謹	尹	謹	崑潤
周憲	周	憲	用章
劉思中	劉	思中	子睿
何汝成	何	汝成	子誠
韓杲	韓	杲	汝素
朱鴻謨	朱	鴻謨	文甫
田樂義	田	樂義	宜卿
齊國儒	齊	國儒	愛道
方肯堂	方	肯堂	子升
程遜	程	遜	惟謙
傅作舟	傅	作舟	元濟
趙鷺	趙	鷺	朝雝
梅淳	梅	淳	德涵
吳從龍	吳	從龍	希德
黃策	黃	策	嘉猷
周文卿	周	文卿	藎之
高應聘	高	應聘	志尹
李應辰	李	應辰	惟星
韓紹	韓	紹	光祖
馬允登	馬	允登	叔先
孟一脉	孟	一脉	嗣孔
周應中	周	應中	正甫
楊維新	楊	維新	克一
張會宗	張	會宗	于震
趙世勛	趙	世勛	光遠
高文炳	高	文炳	象南
李藎	李	藎	臣忱
魏良臣	魏	良臣	以忠
陸夢熊	陸	夢熊	伯祥
宋仕	宋	仕	汝學
姜璧	姜	璧	完卿
吳之彥	吳	之彥	世美
董選	董	選	叔仁
趙世卿	趙	世卿	象賢
李棟	李	棟	尚隆
郭如暄	郭	如暄	元春
孫秉陽	孫	秉陽	夢旭
李華春	李	華春	君實
苗浡然	苗	浡然	秀卿
彭應時	彭	應時	化中
王學書	王	學書	惟中
劉玉成	劉	玉成	自復
曹誥	曹	誥	仲宣
孫鳴鳳	孫	鳴鳳	文瑞
陳履	陳	履	德基
王莚	王	莚	子才
董光裕	董	光裕	子順
李天植	李	天植	性甫
王致祥	王	致祥	德徵
王煥	王	煥	奎章
王度	王	度	惟貞
桑維高	桑	維高	汝抑
袁國臣	袁	國臣	惟鄰
吳之美	吳	之美	學周
秦紳	秦	紳	子佩
白棟	白	棟	子隆
薛夢雷	薛	夢雷	汝奮
帥蘭	帥	蘭	同甫
劉諧	劉	諧	鳳和
宋范	宋	范	希范
沈允成	沈	允成	汝賢
洪聲遠	洪	聲遠	子實
劉中立	劉	中立	徤甫
陳彞典	陳	彞典	元惇
劉珠	劉	珠	海翁
石應岳	石	應岳	鍾賢
夏潛	夏	潛	孔昭
任仕	任	仕	學優
盧一麟	盧	一麟	禎甫
吳從周	吳	從周	崇文
孫繼臯	孫	繼臯	以德
余孟麟	余	孟麟	伯祥
王應選	王	應選	俊卿
支可大	支	可大	有功
周希賢	周	希賢	司謙
王泮	王	泮	宗魯
孫鑛	孫	鑛	文融
沈璟	沈	璟	伯英
馬慥	馬	慥	顧甫
陸檄	陸	檄	羽行
林纉振	林	纉振	公說
蕭景訓	蕭	景訓	希之
蕭應宮	蕭	應宮	伯和
吳顯	吳	顯	景猷
陳大統	陳	大統	一甫
薛道生	薛	道生	士立
管大耀	管	大耀	德臣
陳九敘	陳	九敘	爾纉
佘毅中	佘	毅中	子執
雷應志	雷	應志	立甫
王任	王	任	仁卿
吳同春	吳	同春	伯與
石元麟	石	元麟	君定
陳夢庚	陳	夢庚	台錫
謝裘	謝	裘	子美
張振先	張	振先	文起
蔡乾釜	蔡	乾釜	宜享
余國賓	余	國賓	叔賢
徐元春	徐	元春	正夫
陳國華	陳	國華	堯佐
蘇希栻	蘇	希栻	于欽
容若玉	容	若玉	潔夫
王錄	王	錄	子薦
王家棟	王	家棟	惟隆
馬鳴鑾	馬	鳴鑾	君御
陳邦彥	陳	邦彥	汝美
陶允宜	陶	允宜	懋中
陳述齡	陳	述齡	子壽
汪應蛟	汪	應蛟	蔚翔
許一星	許	一星	拱辰
陳嘉賓	陳	嘉賓	天民
謝詔	謝	詔	彥實
張之屏	張	之屏	憲夫
萬文卿	萬	文卿	存良
劉孟雷	劉	孟雷	靜之
韓濟	韓	濟	克濟
鄒迪光	鄒	迪光	彥吉
洪有聲	洪	有聲	懋文
趙以康	趙	以康	元錫
朱期至	朱	期至	子得
蔡惟亨	蔡	惟亨	永嘉
傅作雨	傅	作雨	元化
范可奇	范	可奇	士頴
蔣三近	蔣	三近	爾德
李鋕	李	鋕	廷新
朱應	朱	應	少徽
陳瑛	陳	瑛	廷王
王橋	王	橋	崇志
張一坤	張	一坤	子簡
孫星	孫	星	少陽
周宗禮	周	宗禮	子仁
黃凝道	黃	凝道	懋德
李時芳	李	時芳	惟榮
張國輔	張	國輔	惟德
張時亨	張	時亨	禮卿
吳中謙	吳	中謙	惟柄
李喬楠	李	喬楠	材達
詹思謙	詹	思謙	惟柄
王道純	王	道純	希文
朱衣	朱	衣	章夫
楊以忠	楊	以忠	顯卿
李良柱	李	良柱	伯任
李三才	李	三才	道夫
陳朴	陳	朴	一初
雷士楨	雷	士楨	國柱
顏素	顏	素	質卿
牛惟炳	牛	惟炳	懋華
易以巽	易	以巽	汝中
孫旬	孫	旬	若穆
楊四知	楊	四知	元述
蘇雨	蘇	雨	以時
曹一夔	曹	一夔	子韶
王問卿	王	問卿	以正
范世美	范	世美	敬之
黃時雨	黃	時雨	化之
魏允孚	魏	允孚	懋誠
夏應星	夏	應星	長卿
李多見	李	多見	子行
常居敬	常	居敬	汝一
史元熙	史	元熙	良明
黃師顏	黃	師顏	有發
王見賓	王	見賓	子利
何鑛	何	鑛	子啟
馬貫	馬	貫	道卿
沈孟化	沈	孟化	叔順
王炳璿	王	炳璿	幼文
賀一孝	賀	一孝	子順
鄭臯	鄭	臯	懋堅
許鋌	許	鋌	定之
韓志道	韓	志道	汝立
馬翰如	馬	翰如	紓之
王職	王	職	君任
陳九成	陳	九成	子韶
郭惟賢	郭	惟賢	哲卿
尹應元	尹	應元	乾泰
劉金	劉	金	子南
陳揚產	陳	揚產	以清
姜召	姜	召	可叔
陳嘉策	陳	嘉策	與偕
沈鈇	沈	鈇	繼揚
翁仲益	翁	仲益	贊德
陳王庭	陳	王庭	惟獻
胡希舜	胡	希舜	惟善
張雲翱	張	雲翱	文升
曾夢鰲	曾	夢鰲	君瞻
何允升	何	允升	吉甫
林鳴盛	林	鳴盛	元和
于翰	于	翰	思憲
敖選	敖	選	用卿
陳正誼	陳	正誼	道甫
姚德重	姚	德重	士欽
曾士彥	曾	士彥	從之
李坤	李	坤	叔簡
郭衢階	郭	衢階	享甫
李際春	李	際春	華卿
劉三宅	劉	三宅	可任
查偉	查	偉	德充
蔡時鼎	蔡	時鼎	台甫
林兆珂	林	兆珂	懋忠
李承志	李	承志	道甫
楊時馨	楊	時馨	維德
陳諫	陳	諫	直卿
顧連璧	顧	連璧	曰温
王儒	王	儒	汝為
何鳳起	何	鳳起	文興
倪三綬	倪	三綬	守秩
任甲第	任	甲第	子薦
龔一清	龔	一清	仲和
韓國楨	韓	國楨	柱甫
宋萬葉	宋	萬葉	啟紹
毛在	毛	在	君明
吳中傳	吳	中傳	汝和
楊俊士	楊	俊士	伯賢
游朴	游	朴	太初
陳與郊	陳	與郊	廣野
留震臣	留	震臣	龍德
蔡國炳	蔡	國炳	誠中
譚希思	譚	希思	子誠
南憲仲	南	憲仲	子章
龔錫爵	龔	錫爵	汝脩
田蕙	田	蕙	應秀
馮露	馮	露	瑞化
王開	王	開	維泰
王鳳竹	王	鳳竹	允在
李化龍	李	化龍	于田
劉弘道	劉	弘道	志甫
王一言	王	一言	民法
王國賓	王	國賓	用卿
俞良史	俞	良史	天榮
吳謙	吳	謙	原豫
謝杰	謝	杰	漢甫
周夢暘	周	夢暘	啟明
顧爾行	顧	爾行	慎卿
吳應奎	吳	應奎	孟才
王景星	王	景星	仲祥
林民正	林	民正	敬夫
陳濟	陳	濟	道行
徐師張	徐	師張	惟敬
張世則	張	世則	惟範
張汝賢	張	汝賢	用甫
朱讓	朱	讓	次夔
王毓陽	王	毓陽	春裕
黃門	黃	門	道登
張廷榜	張	廷榜	登材
廖恒吉	廖	恒吉	思德
唐伯元	唐	伯元	仁卿
楊楫	楊	楫	允通
王三宅	王	三宅	仁所
李宗魯	李	宗魯	惟誠
伍讓	伍	讓	子謙
朱翰臣	朱	翰臣	學甫
孫健	孫	健	用純
王致中	王	致中	懋和
李以謙	李	以謙	從吉
舒邦儒	舒	邦儒	真卿
陳紳	陳	紳	觀佩
董繼祖	董	繼祖	承芳
李士達	李	士達	伯順
吳定	吳	定	子得
卓世彥	卓	世彥	邦美
鄭材	鄭	材	思成
李得祐	李	得祐	天吉
周弘禴	周	弘禴	元孚
王三餘	王	三餘	效勤
顧夢鯉	顧	夢鯉	仲龍
程有守	程	有守	思約
范淶	范	淶	原易
陳正謨	陳	正謨	宗禹
楊瑞雲	楊	瑞雲	肖韓
黃道瞻	黃	道瞻	臨汝
余啟元	余	啟元	伯貞
朱正色	朱	正色	應明
田大年	田	大年	仰彭
陳應芳	陳	應芳	世龍
陳一魴	陳	一魴	鈞從
陳奇謀	陳	奇謀	嘉猷
沈汝梁	沈	汝梁	邦楨
趙維魚	趙	維魚	夢龍
陳文炅	陳	文炅	汝晦
蔡夢說	蔡	夢說	君弼
高梅	高	梅	汝調
李杜	李	杜	古哲
何思登	何	思登	一舉
王邦俊	王	邦俊	士賢
葉遵	葉	遵	子憲
李好問	李	好問	宗舜
韓萃善	韓	萃善	克一
黃雲龍	黃	雲龍	逢元
司馬祉	司馬	祉	敬甫
李進道	李	進道	明叔
王价	王	价	藩甫
徐待	徐	待	子器
顧起淹	顧	起淹	師范
李廷彥	李	廷彥	希聖
朱熙洽	朱	熙洽	鴻甫
熊夢兆	熊	夢兆	應徵
趙秉忠	趙	秉忠	藎臣
劉美	劉	美	懋實
李學詩	李	學詩	可言
張佐治	張	佐治	思謀
劉懋中	劉	懋中	可參
朱道南	朱	道南	統文
詹啟東	詹	啟東	知震
饒廷錫	饒	廷錫	文命
孫兖	孫	兖	應文
秦應驄	秦	應驄	行之
戈大本	戈	大本	性甫
劉汝桂	劉	汝桂	攀甫
江鐸	江	鐸	士振
丁汝謙	丁	汝謙	子益
姚士觀	姚	士觀	正甫
閻芹	閻	芹	時獻
李寀	李	寀	邦亮
劉朝噩	劉	朝噩	質之
劉士忠	劉	士忠	純卿
張珩	張	珩	珮卿
胡桂芳	胡	桂芳	時榮
王國祚	王	國祚	世長
范守己	范	守己	介儒
趙南星	趙	南星	拱極
陳朂	陳	朂	世勉
陳于階	陳	于階	子陞
楊廷相	楊	廷相	君贊
杜希鵬	杜	希鵬	化甫
邢侗	邢	侗	子愿
支大綸	支	大綸	心易
王懋中	王	懋中	惟一
傅好禮	傅	好禮	伯恭
何倬	何	倬	明夫
王繼明	王	繼明	用晦
張名藩	張	名藩	价甫
邊有猷	邊	有猷	克壯
陳相	陳	相	以道
蕭大才	蕭	大才	允成
高萃	高	萃	升伯
黃體乾	黃	體乾	行健
金和	金	和	元節
丁懋建	丁	懋建	元敬
李堯民	李	堯民	汝化
馬洛	馬	洛	呈書
屈灼	屈	灼	見夫
羅應兆	羅	應兆	元發
董廷策	董	廷策	對甫
周詩	周	詩	言志
文在中	文	在中	德充
姚三讓	姚	三讓	崇謙
田時秀	田	時秀	子實
劉騰霄	劉	騰霄	子翀
褚順	褚	順	子安
倪凍	倪	凍	霖仲
吳仕詮	吳	仕詮	子用
梁鵬	梁	鵬	孔適
胡汝寧	胡	汝寧	文禎
李臣之	李	臣之	思良
楊寅秋	楊	寅秋	義叔
吳澋	吳	澋	文煥
李大嘉	李	大嘉	子美
任養心	任	養心	子誠
梁必強	梁	必強	柔可
赫瀛	赫	瀛	登甫
郝國章	郝	國章	廷符
阮子孝	阮	子孝	伯慕
張夢蟾	張	夢蟾	應光
張問達	張	問達	德孚
袁應祺	袁	應祺	文穀
嵇應科	嵇	應科	文甫
方範	方	範	敘道
郭性之	郭	性之	德安
貢靖國	貢	靖國	玄忠
沈懋學	沈	懋學	君典
張嗣修	張	嗣修	景仁
曾朝節	曾	朝節	直卿
宋希堯	宋	希堯	淑中
陸可教	陸	可教	敬承
馮夢禎	馮	夢禎	開之
劉庭芥	劉	庭芥	介徵
楊起元	楊	起元	貞復
沈大忠	沈	大忠	惟孝
楊德政	楊	德政	公亮
張文奇	張	文奇	原正
盛世承	盛	世承	以烈
張問仁	張	問仁	為春
鄭一麟	鄭	一麟	世禎
蘇濬	蘇	濬	君禹
黃學顏	黃	學顏	子愚
尤光被	尤	光被	子輝
李元齡	李	元齡	仁卿
趙健	趙	健	中甫
王再聘	王	再聘	任之
許國瓚	許	國瓚	鼎卿
楊際會	楊	際會	士遇
于達真	于	達真	子冲
唐守欽	唐	守欽	宗堯
馮琦	馮	琦	用韞
沈九疇	沈	九疇	箕仲
王明時	王	明時	治甫
孫成泰	孫	成泰	允交
王豫	王	豫	介夫
郭師古	郭	師古	時用
周汝登	周	汝登	繼元
劉九澤	劉	九澤	汝濟
章潤	章	潤	實甫
房守士	房	守士	升甫
李楠	李	楠	子梁
蔡斗移	蔡	斗移	元運
沈季文	沈	季文	少卿
莊履豐	莊	履豐	中熙
韓取善	韓	取善	克從
王謙	王	謙	子牧
周汝礪	周	汝礪	若金
呂興周	呂	興周	維師
董樾	董	樾	子亨
諸大圭	諸	大圭	信夫
李守約	李	守約	善夫
鄭有年	鄭	有年	國瑞
鄭璧	鄭	璧	子良
閻邦	閻	邦	至道
郭元柱	郭	元柱	直甫
張斗	張	斗	景北
張鼎思	張	鼎思	睿甫
高尚忠	高	尚忠	藎卿
甘雨	甘	雨	應溥
劉際可	劉	際可	禮卿
吳子韶	吳	子韶	維成
王之麟	王	之麟	汝禎
胡泰	胡	泰	道安
馬象乾	馬	象乾	體良
金炅	金	炅	元晦
伍惟忠	伍	惟忠	效之
朱維京	朱	維京	可大
馮景隆	馮	景隆	叔熙
黃正色	黃	正色	端甫
任可容	任	可容	子賢
王繼光	王	繼光	于善
張文熙	張	文熙	質卿
劉霖	劉	霖	時沛
賈三策	賈	三策	資言
陳瑫	陳	瑫	國輝
袁有鳳	袁	有鳳	時儀
王約	王	約	伯一
劉世埏	劉	世埏	敬脩
陳性學	陳	性學	所養
趙楷	趙	楷	憲吾
姚岳祥	姚	岳祥	于定
徐桂	徐	桂	茂吳
韓應庚	韓	應庚	希白
俞霑	俞	霑	時澤
魏允貞	魏	允貞	懋明
顧紹芳	顧	紹芳	實甫
鄭之民	鄭	之民	可行
王鍵	王	鍵	德閒
姚元禎	姚	元禎	開甫
黃嘉善	黃	嘉善	惟尚
余繼登	余	繼登	世用
蔣時馨	蔣	時馨	德夫
楊植	楊	植	爾立
敖文禎	敖	文禎	嘉猷
楊文舉	楊	文舉	直卿
何洛書	何	洛書	啟範
劉士瑗	劉	士瑗	允玉
李日文	李	日文	維實
張新	張	新	元鼎
李文郁	李	文郁	先質
胡士鰲	胡	士鰲	爾潛
史繼辰	史	繼辰	應之
李國士	李	國士	汝志
朱來遠	朱	來遠	文臣
張一德	張	一德	心得
朱廷益	朱	廷益	汝虞
黃文炳	黃	文炳	懋新
王命爵	王	命爵	元德
蘇鄼	蘇	鄼	漢傑
朱應轂	朱	應轂	德載
徐震	徐	震	起之
李弘道	李	弘道	汝大
趙崇善	趙	崇善	汝性
吳夢熊	吳	夢熊	應望
陸承憲	陸	承憲	子永
張棟	張	棟	伯任
李琯	李	琯	邦和
呂乾健	呂	乾健	天常
吳達可	吳	達可	叔行
周盤	周	盤	儆予
伍可受	伍	可受	以大
馬化龍	馬	化龍	雲從
黃承讚	黃	承讚	相孫
祁鯤	祁	鯤	仲化
南兆	南	兆	吉甫
張養志	張	養志	子尚
史朝錄	史	朝錄	登之
林休徵	林	休徵	景徵
劉一相	劉	一相	維衡
汪言臣	汪	言臣	可忠
凌登瀛	凌	登瀛	元學
徐上達	徐	上達	孔學
張守朴	張	守朴	元卿
曹一鵬	曹	一鵬	子運
李一陽	李	一陽	長卿
徐申	徐	申	維嶽
何存斆	何	存斆	念卿
陳燁	陳	燁	子潛
刑孔陽	刑	孔陽	公照
方端	方	端	察甫
張子忠	張	子忠	獻可
王世揚	王	世揚	孝甫
張養蒙	張	養蒙	叔亨
饒學詩	饒	學詩	言卿
鄧鍊	鄧	鍊	文純
陳應熙	陳	應熙	仲穆
丁此呂	丁	此呂	右武
楊鳴鳳	楊	鳴鳳	子儀
白一言	白	一言	子恕
詹事講	詹	事講	明甫
賀逢舜	賀	逢舜	一龍
孫瀾	孫	瀾	子源
潘元和	潘	元和	節甫
謝志伊	謝	志伊	大公
吳安國	吳	安國	文仲
張文耀	張	文耀	養晦
曹鈇	曹	鈇	民威
劉敏寬	劉	敏寬	伯功
李觀光	李	觀光	賓之
管應鳳	管	應鳳	肇和
宋附	宋	附	仲翼
徐三畏	徐	三畏	子敬
張國璽	張	國璽	君信
李際春	李	際春	和元
孫世禎	孫	世禎	正甫
張志	張	志	于道
白希繡	白	希繡	惟錦
葉承遇	葉	承遇	思章
秦可貞	秦	可貞	季章
謝應典	謝	應典	道揚
程達	程	達	于順
董子行	董	子行	明卿
支應瑞	支	應瑞	汝賢
楊東野	楊	東野	啟明
朱南英	朱	南英	子醇
屠隆	屠	隆	長卿
范儁	范	儁	國士
傅光宅	傅	光宅	伯安
黃學曾	黃	學曾	唯吾
王國	王	國	之楨
顧雲程	顧	雲程	務遠
霍鵬	霍	鵬	雲程
李應祥	李	應祥	善徵
屠叔方	屠	叔方	宗直
王亮	王	亮	茂大
朱維藩	朱	維藩	价卿
張世科	張	世科	濟美
陳禹謨	陳	禹謨	孟文
孫瑋	孫	瑋	純玉
楊有仁	楊	有仁	以義
李驥千	李	驥千	伯顧
李洙	李	洙	源魯
陳泰來	陳	泰來	上交
丘度	丘	度	汝洪
鄒元標	鄒	元標	爾瞻
沈存仁	沈	存仁	愛甫
沈自邠	沈	自邠	茂仁
胡載道	胡	載道	文甫
吳世賓	吳	世賓	汝嘉
陳一洙	陳	一洙	國潢
侯應徵	侯	應徵	公選
陳三策	陳	三策	幼學
盧洪春	盧	洪春	思仁
王元	王	元	叔調
李杜	李	杜	漢卿
陳璨	陳	璨	子光
李先著	李	先著	子明
何懋官	何	懋官	希賢
盧學禮	盧	學禮	立甫
馬朝陽	馬	朝陽	鳳鳴
楊起元	楊	起元	體仁
李應選	李	應選	子登
浦卿	浦	卿	良弼
李贄	李	贄	子執
馮生虞	馮	生虞	德卿
沈夢斗	沈	夢斗	應宿
金節	金	節	持甫
張堯臣	張	堯臣	希夔
賈希夷	賈	希夷	子清
傅國珍	傅	國珍	君聘
陳璧	陳	璧	道良
徐三重	徐	三重	伯同
王之猷	王	之猷	爾嘉
劉綺	劉	綺	文先
曹煒	曹	煒	原誠
馬崇謙	馬	崇謙	子益
張夢鯉	張	夢鯉	化龍
高桂	高	桂	崇芳
郭顯忠	郭	顯忠	步武
張希臯	張	希臯	直卿
沈孚聞	沈	孚聞	貞孺
郝潔	郝	潔	元玉
曾乾亨	曾	乾亨	于健
鍾宇淳	鍾	宇淳	道復
王士性	王	士性	恒叔
和震	和	震	起甫
趙一鵬	趙	一鵬	化卿
沈瑞臨	沈	瑞臨	夢錫
蔡萬里	蔡	萬里	巨卿
魏濬	魏	濬	象涵
吳之鵬	吳	之鵬	汝南
楊芳	楊	芳	以德
宋國相	宋	國相	時佐
羅用敬	羅	用敬	子直
王九儀	王	九儀	維邦
陳邦科	陳	邦科	俊卿
吳堯弼	吳	堯弼	宗舜
黃曰謹	黃	曰謹	元祇
金枝	金	枝	本懋
田如京	田	如京	子庾
趙邦秩	趙	邦秩	元敘
傅霈	傅	霈	應霑
馬玉麟	馬	玉麟	德徵
何文極	何	文極	美中
林國材	林	國材	崇元
陳良棟	陳	良棟	用隆
陳揚善	陳	揚善	宗舜
陳遇文	陳	遇文	鳴周
簡繼芳	簡	繼芳	師啟
譚耀	譚	耀	章伯
鄧鶴	鄧	鶴	子臯
盧逵	盧	逵	秉漸
黃鍾	黃	鍾	律元
向僎	向	僎	良佐
黃袞	黃	袞	補甫
徐聯芳	徐	聯芳	元實
程奎	程	奎	國光
陳與相	陳	與相	卜野
苗朝陽	苗	朝陽	遇之
李載陽	李	載陽	子春
趙夢日	趙	夢日	應瑞
連格	連	格	孟式
李植	李	植	汝培
陳登雲	陳	登雲	從龍
張維新	張	維新	憲周
陸玠	陸	玠	仲玉
方萬山	方	萬山	仰之
陳簡	陳	簡	居敬
田一麟	田	一麟	道徵
陳九疇	陳	九疇	時敘
葉祖堯	葉	祖堯	允中
孫玄	孫	玄	叔乾
陳九官	陳	九官	忠甫
張一心	張	一心	道宗
萬象春	萬	象春	仁甫
吳道行	吳	道行	名世
馬應圖	馬	應圖	心易
羊可立	羊	可立	子豫
劉懷恕	劉	懷恕	士行
原一魁	原	一魁	仲文
荊州土	荊	州土	至元
魯錦	魯	錦	文叔
杜和春	杜	和春	體健
甘士价	甘	士价	維藩
沈時敘	沈	時敘	公納
曲遷喬	曲	遷喬	允升
譚桂	譚	桂	世芳
費尚伊	費	尚伊	國聘
甯化龍	甯	化龍	文明
吳文梓	吳	文梓	子喬
張敬	張	敬	爾和
黃卷	黃	卷	汝通
江東之	江	東之	長信
程宗伊	程	宗伊	道鳴
陳祹	陳	祹	惟膺
郁文	郁	文	從周
易登瀛	易	登瀛	君選
張懋修	張	懋修	惟時
蕭良有	蕭	良有	以占
王庭譔	王	庭譔	敬卿
董嗣成	董	嗣成	伯念
顧憲成	顧	憲成	叔時
溫顯	溫	顯	公宣
張泰徵	張	泰徵	懋同
李同芳	李	同芳	濟美
王德新	王	德新	應明
邵夢弼	邵	夢弼	仲良
路雲龍	路	雲龍	伯際
黃克纘	黃	克纘	紹夫
陸長庚	陸	長庚	元白
姜士昌	姜	士昌	仲文
湯日昭	湯	日昭	子德
張敬修	張	敬修	君平
余寅	余	寅	君房
張中鴻	張	中鴻	允獲
于文熙	于	文熙	元敬
馮時泰	馮	時泰	德交
孫溫如	孫	溫如	玉叔
葉萬景	葉	萬景	霽伯
李懋檜	李	懋檜	克蒼
楊同善	楊	同善	克一
謝文炳	謝	文炳	復元
楊現	楊	現	廷蘊
袁年	袁	年	子壽
楊于庭	楊	于庭	道行
葉雲礽	葉	雲礽	奕甫
孟化鯉	孟	化鯉	叔龍
陸汴	陸	汴	梁彥
張恒	張	恒	伯常
史邦載	史	邦載	元熙
蔣瑞卿	蔣	瑞卿	景雲
盧文勳	盧	文勳	堯卿
錢濬	錢	濬	啟祥
張治樞	張	治樞	明勵
閻汝哲	閻	汝哲	克明
李芳	李	芳	本植
黃子美	黃	子美	尚含
徐秉正	徐	秉正	朝直
周一鵬	周	一鵬	圖南
劉曰桂	劉	曰桂	汝芳
徐泰時	徐	泰時	大來
鄒雲鵬	鄒	雲鵬	翼卿
沈修	沈	修	吉甫
彭夢祖	彭	夢祖	應壽
陳榛	陳	榛	君實
孟紹慶	孟	紹慶	爾申
林民悅	林	民悅	益夫
沈一中	沈	一中	長孺
薛士彥　	薛	士彥　	道譽
盧大順	盧	大順	子達
趙壽祖	趙	壽祖	山甫
王乾亨	王	乾亨	應元
董基	董	基	繼可
尤錫類	尤	錫類	孝徵
衛一鳳	衛	一鳳	伯瑞
蕭良譽　	蕭	良譽　	以孚
邵伯悌	邵	伯悌	本敬
魏允中	魏	允中	懋權
吳嶽秀　	吳	嶽秀　	幼鍾
鄒龍光	鄒	龍光	彥為
劉任	劉	任	體仁
林士弘	林	士弘	仁甫
孫愈賢	孫	愈賢	可聖
塗時相	塗	時相	明輔　
蔡系周	蔡	系周	伯子
向東	向	東	紹明
張喬松	張	喬松	爾操
褚九臯	褚	九臯	聞遠
劉如寵	劉	如寵	介卿
吳獻台	吳	獻台	啟袞
張後甲	張	後甲	丁也
項復弘	項	復弘	惟重
蔡昇	蔡	昇	弘晉
楊其休	楊	其休	振孫
張有德	張	有德	道修
穆來輔	穆	來輔	誨之
王守素	王	守素	德孚
秦大夔	秦	大夔	舜卿
龍膺	龍	膺	君善
王嗣美	王	嗣美	實之
錢檟	錢	檟	仲美
李之用	李	之用	實卿
王道增	王	道增	益甫
董元學	董	元學	汝覺
吳宗熹	吳	宗熹	伯焜
彭國光	彭	國光	用卿
周友程	周	友程	明昆
苑時葵	苑	時葵	向卿
王希曾	王	希曾	道宗
徐元	徐	元	善良
凌嗣音	凌	嗣音	孟昭
閻士選	閻	士選	儁甫
劉羽國	劉	羽國	辰熙
閔世翔	閔	世翔	仲升
洪有復	洪	有復	懋純
徐桓	徐	桓	國武
褚棟	褚	棟	伯隆
鄧炳	鄧	炳	其文
李天麟	李	天麟	仲仁
李正蒙	李	正蒙	汝明
劉卿	劉	卿	德懋
沈子來	沈	子來	汝脩
柯挺	柯	挺	以拔
蔡琮	蔡	琮	應崑
文德	文	德	修甫
陳惟芝	陳	惟芝	德禎
王鑰	王	鑰	文啟
徐伸	徐	伸	允達
莫揚	莫	揚	子充
霍從教	霍	從教	汝似
喬因羽	喬	因羽	思儀
陳石卿	陳	石卿	大忠
汪可受	汪	可受	以虛
高芳	高	芳	孟遠
葉隆元	葉	隆元	治卿
梁宜生	梁	宜生	際元
史善言	史	善言	指遠
劉應龍	劉	應龍	文見
邢雲路	邢	雲路	士登
劉煥	劉	煥	文華
李汝相	李	汝相	希說
胡旦	胡	旦	穉明
陳經濟	陳	經濟	獻明
鍾羽正	鍾	羽正	淑濂
劉元霖	劉	元霖	无澤
馬維銘	馬	維銘	新甫
陸懋龍	陸	懋龍	啟原
江宗棐	江	宗棐	叔忠
王慎德	王	慎德	元明
高薦	高	薦	應詔
辛志登	辛	志登	士先
徐自興	徐	自興	汝傑
劉汝立	劉	汝立	學禮
饒位	饒	位	廷立
周孔教	周	孔教	明行
黃紀賢	黃	紀賢	常甫
謝時泰	謝	時泰	汝亨
吳禮嘉	吳	禮嘉	會之
周應治	周	應治	君衡
蔡逢時	蔡	逢時	應期
周班爵	周	班爵	錫卿
丘汝材	丘	汝材	德甫
孫一俊	孫	一俊	應章
王象蒙	王	象蒙	子正
臧懋循	臧	懋循	晉叔
劉之龍	劉	之龍	起潛
邵以仁	邵	以仁	純甫
游應龍	游	應龍	廷從
袁奎	袁	奎	文卿
李元吉	李	元吉	允卿
姜孟龍	姜	孟龍	中甫
詹思虞	詹	思虞	惟業
沈儆焞	沈	儆焞	仲亨
祝大舟	祝	大舟	濟之
龔仲慶	龔	仲慶	惟長
林廷陞	林	廷陞	彥賓
郭萬里	郭	萬里	雲程
陳紹功	陳	紹功	及卿
柳希點	柳	希點	汝志
孫瑀	孫	瑀	子章
朱朝聘	朱	朝聘	希尹
左之宜	左	之宜	用善
張肇	張	肇	子基
馮應鳳	馮	應鳳	邦瑞
謝吉卿	謝	吉卿	修之
王大謨	王	大謨	惟允
馬朝錫	馬	朝錫	晉卿
呂一鳳	呂	一鳳	舜卿
謝與思	謝	與思	見齊
胡懋忠	胡	懋忠	良卿
趙士登	趙	士登	應庸
崔斗瞻	崔	斗瞻	仰之
沈堯中	沈	堯中	心唐
張鳴岡	張	鳴岡	治禎
楊位	楊	位	德興
江有源	江	有源	進卿
傅崇明	傅	崇明	子達
黃淳	黃	淳	叔化
金銓	金	銓	衡卿
陳載春	陳	載春	子元
萬自約	萬	自約	崇禮
黎芳	黎	芳	懋德
章邦翰	章	邦翰	公佐
杜縻	杜	縻	惟公
林可成	林	可成	志文
許守恩	許	守恩	君賜
高舉	高	舉	鵬程
車大任	車	大任	子仁
褚國祥	褚	國祥	徵興
董瀾	董	瀾	惟源
孫架	孫	架	國棟
王庭諭	王	庭諭	命卿
王麟趾	王	麟趾	瑞甫
鍾化民	鍾	化民	惟新
劉學曾	劉	學曾	唯一
李士登	李	士登	聯之
喬璧星	喬	璧星	文見
蔡宗周	蔡	宗周	敬冕
但貴元	但	貴元	仁甫
項應祥	項	應祥	汝和
張汝蘊	張	汝蘊	子發
譚一召	譚	一召	忠卿
鄒觀光	鄒	觀光	孚如
周光復	周	光復	元禮
余懋中	余	懋中	德懋
李槃	李	槃	用甫
張立愛	張	立愛	子仁
李廷謨	李	廷謨	明皐
劉以平	劉	以平	體衡
茅崇本	茅	崇本	仲立
伍袁萃	伍	袁萃	道聚
任讓	任	讓	退之
靳邵謙	靳	邵謙	受之
陳映	陳	映	東甫
劉庭蕙	劉	庭蕙	惠徵
劉順徵	劉	順徵	懋承
吳之佳	吳	之佳	公美
張我續	張	我續	胤祧
黃師文	黃	師文	繼周
閔一范	閔	一范	仲甫
彭應參	彭	應參	汝省
張鶴鳴	張	鶴鳴	汝誠
侯先春	侯	先春	元甫
張廷棟	張	廷棟	國材
黃齊賢	黃	齊賢	仕思
盧泮	盧	泮	□文
鄧啟愚	鄧	啟愚	良知
郝大猷	郝	大猷	定甫
于孔兼	于	孔兼	元時
彭而珩	彭	而珩	命卿
蔣春芳	蔣	春芳	實伯
郝世科	郝	世科	肖登
陳仕行	陳	仕行	道敷
吳之龍	吳	之龍	汝陽
史旌賢	史	旌賢	廷徵
許弘綱	許	弘綱	張之
賈一鶚	賈	一鶚	文薦
傅履禮	傅	履禮	則庸
韓介	韓	介	于石
葉初春	葉	初春	處元
李大欽	李	大欽	惟敬
尹從教	尹	從教	心傳
鹿久徵	鹿	久徵	子誠
章嘉楨	章	嘉楨	元禮
孫珫	孫	珫	子文
凃用賓	凃	用賓	晉卿
王明	王	明	汝亮
朱運昌	朱	運昌	允升
劉日升	劉	日升	爾湛
張鉦	張	鉦	振甫
祝致和	祝	致和	達卿
余繼善	余	繼善	明復
劉㫤	劉	㫤	叔通
李本固	李	本固	叔茂
杜潛	杜	潛	孔昭
李上馨	李	上馨	子升
王應麟	王	應麟	仁卿
謝台卿	謝	台卿	登之
丁懋遜	丁	懋遜	允節
王永寧	王	永寧	世卿
江應禎	江	應禎	興甫
李登	李	登	伯庸
錢士完	錢	士完	惟凝
王夢暘	王	夢暘	旭東
徐民式	徐	民式	用敬
張大謨	張	大謨	希皐
陳子貞	陳	子貞	以成
張棟	張	棟	士隆
孫光祖	孫	光祖	孝光
趙岸	趙	岸	登之
王九德	王	九德	惟恒
李來鳳	李	來鳳	瑞黃
張季思	張	季思	以誠
王顯仁	王	顯仁	克明
南企仲	南	企仲	子及
佘鳴化	佘	鳴化	邦儀
郝持	郝	持	敬之
王以通	王	以通	可貞
陳效	陳	效	忠甫
羅萬程	羅	萬程	時騰
楊鎬	楊	鎬	京甫
王三陽	王	三陽	乾甫
唐仲寅	唐	仲寅	啟東
李汝華	李	汝華	茂夫
曾維倫	曾	維倫	恒遜
盧奇	盧	奇	廷才
王元命	王	元命	長齡
劉庭蘭	劉	庭蘭	國徵
黃櫸	黃	櫸	思直
周維翰	周	維翰	惠叔
王應霖	王	應霖	德徵
陳尚象	陳	尚象	心易
林文英	林	文英	德甫
楊東明	楊	東明	子旭
黃守謙	黃	守謙	君有
石崑玉	石	崑玉	汝重
凃嘉會	凃	嘉會	君履
朱天應	朱	天應	國聘
鄭國柱	鄭	國柱	藎臣
朱國祚	朱	國祚	兆隆
李廷機	李	廷機	爾張
劉應秋 	劉	應秋 	士和
周應賓	周	應賓	君貺
張坤	張	坤	伯簡
劉志選	劉	志選	可選
麻溶	麻	溶	明之
王荁	王	荁	季孺
盛萬年	盛	萬年	民祈
史記勳	史	記勳	稽叔
莫睿	莫	睿	思卿
史孟麟	史	孟麟	際明
林紹用	林	紹用	向卿
張甲徵	張	甲徵	懋 一
葉向高	葉	向高	進卿
王紹先	王	紹先	伯生
王佐	王	佐	翼卿
陸鎮默 	陸	鎮默 	厚躬
孫光啟	孫	光啟	子貽
饒伸	饒	伸	廷抑
蔡應麟	蔡	應麟	子瑞
何繼高	何	繼高	汝登
方應選	方	應選	眾甫
申用懋	申	用懋	敬中
鄒德溥	鄒	德溥	汝光
徐即登	徐	即登	獻和
錢守成 	錢	守成 	克賢
王士崧	王	士崧	中叔
袁應陽	袁	應陽	道饒
郭正域	郭	正域	美命
俞顯卿	俞	顯卿	子如
殷都	殷	都	開美
方從哲	方	從哲	汝愚
胡應辰	胡	應辰	汝拱
李開藻	李	開藻	啟鑑
張壽朋 	張	壽朋 	冲龢
王士琦	王	士琦	圭叔
沈烝	沈	烝	胤盛
劉復初	劉	復初	貽哲
白所知	白	所知	廷謨
陳所學	陳	所學	正甫
王岳錫	王	岳錫	子正
高世芳	高	世芳	德芳
陳汝學	陳	汝學	仲道
季東魯	季	東魯	國望
于玉立	于	玉立	中甫
陳廉	陳	廉	威如
項承芳	項	承芳	達甫
李民質	李	民質	元素
徐大化	徐	大化	文明
林國相	林	國相	廷賛
安世鳳	安	世鳳	鳳來
孫如法	孫	如法	世行
丁繼嗣	丁	繼嗣	國雲
張悌	張	悌	叔愛
陳一簡	陳	一簡	敬甫
郭廷良	郭	廷良	弼明
邵庶	邵	庶	明卿
王祺	王	祺	兆吉
詹在泮	詹	在泮	獻功
何鯉	何	鯉	伯龍
楊信	楊	信	以成
胡篤卿	胡	篤卿	用光
李開芳	李	開芳	啟東
蕭雍	蕭	雍	思賢
王堯封	王	堯封	爾祝
莊履朋	莊	履朋	中益
虞淳熙	虞	淳熙	澹然
盧夢錫	盧	夢錫	國禎
劉應同	劉	應同	春卿
楊元祥	楊	元祥	曰泰
龔雲致	龔	雲致	迪潤
章尚學	章	尚學	宗理
安文璧	安	文璧	仲書
沈良臣	沈	良臣	允中
陸起龍	陸	起龍	震卿
楊恂 	楊	恂 	以純
曹楷	曹	楷	正夫
方萬策	方	萬策	元忠
唐一鵬	唐	一鵬	九萬
方懋學	方	懋學	壯行
俞咨禹	俞	咨禹	司平
潘士藻	潘	士藻	去華
聞金和	聞	金和	韶初
李獻可	李	獻可	堯俞
陳汝壁	陳	汝壁	立父
周九臯	周	九臯	翀明
季道統	季	道統	亦卿
徐萬仞	徐	萬仞	抑之
葉修	葉	修	克慎
張守乾	張	守乾	汝徤
崔景榮	崔	景榮	自強
呂胤昌	呂	胤昌	玉繩
王時濟	王	時濟	道甫
吳堯臣	吳	堯臣	師錫
程德良	程	德良	凝之
任悊	任	悊	四明
陳繼疇	陳	繼疇	師洛
馬猶龍	馬	猶龍	長平
王道顯	王	道顯	當世
錢一本 	錢	一本 	國端
于若瀛	于	若瀛	子步　
陳其志	陳	其志	公衡
周之基	周	之基	季卿
徐榜	徐	榜	賢甫
李周策	李	周策	獻卿
秦嵩	秦	嵩	中望
錢汝梁	錢	汝梁	用甫
周子文	周	子文	岐陽
江中信	江	中信	汝成
張問達	張	問達	德允
舒弘緒	舒	弘緒	崇孝
段克允	段	克允	子明
孫湛吾	孫	湛吾	涵虛
柯茂竹	柯	茂竹	堯叟
崔謙亨	崔	謙亨	會卿
李化龍	李	化龍	惟時
甯中立	甯	中立	爾強
楊鳳	楊	鳳	儀虞
王之棟	王	之棟	養隆
張應揚	張	應揚	仲言
李徽猷	李	徽猷	伯建
范醇敬	范	醇敬	子厚
尤應魯	尤	應魯	爾言
沈鳳岐	沈	鳳岐	德輝
涂宗濬	涂	宗濬	及甫
王有功	王	有功	可大
楊紹程 	楊	紹程 	儒系
丁應泰	丁	應泰	元父
吳華	吳	華	子實
萬國欽	萬	國欽	和甫
蕭汝芳	蕭	汝芳	斯妍
顏洪範	顏	洪範	中起
張燁	張	燁	斂華
葛曦	葛	曦	仲明
俞士章	俞	士章	汝成
張惟方	張	惟方	崇仁
陳震	陳	震	潛甫
王室垣	王	室垣	維翰
梅國楨	梅	國楨	公生
陳公相 	陳	公相 	子顯
李生芳	李	生芳	文明
劉一瀾	劉	一瀾	子觀
何必麟	何	必麟	瑞卿
高知止	高	知止	明甫
許國誠	許	國誠	鼎臣
周昊	周	昊	曰明
楊應宿	楊	應宿	宗辰
張天德	張	天德	新吾
胡時麟	胡	時麟	靈昭
蔣應震	蔣	應震	蟄甫
陳良軸	陳	良軸	鳳父
蔡承植	蔡	承植	以發
荊州俊	荊	州俊	章甫
林朝鑰	林	朝鑰	希平
何出光	何	出光	兆文
葉繼美	葉	繼美	章含
劉鹿鳴	劉	鹿鳴	子示
楊應聘	楊	應聘	志尹
徐良選	徐	良選	幼元
沈昌期	沈	昌期	廷際
劉不溢	劉	不溢	謙甫
林道楠	林	道楠	廷任
曾鳳儀	曾	鳳儀	舜徵
樂元聲	樂	元聲	子初
潘敦復	潘	敦復	彥恒
陳秉浩	陳	秉浩	惟直
陳九德	陳	九德	懋夫
朱長春	朱	長春	太復
李復陽	李	復陽	宗誠
沈權	沈	權	中行
楊文煥	楊	文煥	太素
程文 	程	文 	質夫
趙彥	趙	彥	毓美
姜鏡	姜	鏡	永明
張文華	張	文華	兩茂
韓光曙	韓	光曙	明伯
劉三才	劉	三才	汝立
羅心堯	羅	心堯	允中
王遵訓	王	遵訓	而紹
張應登	張	應登	玉車
劉鎮	劉	鎮	雅居
周學易	周	學易	子時
劉芳譽	劉	芳譽	實甫
任應徵	任	應徵	文庸
潘桂	潘	桂	季選
王政	王	政	正之
馬慤	馬	慤	慎卿
梅鵾祚	梅	鵾祚	仲舉
華廷詔	華	廷詔	與恩
章守誠	章	守誠	仲明
王夢鯉	王	夢鯉	子化
涂文奎	涂	文奎	汝光
劉文徵	劉	文徵	懋學
崔士棨	崔	士棨	傳甫
馬拯	馬	拯	吉甫
張堯文	張	堯文	宗欽
龔廷賓	龔	廷賓	可賢
郭實	郭	實	華伯
南邦化	南	邦化	以德
黃洽中	黃	洽中	伯禮
侯慶遠	侯	慶遠	公善
劉奕	劉	奕	元承
馮渠	馮	渠	達甫
張主敬	張	主敬	茂倩
李茂春	李	茂春	蔚元
吳維魁	吳	維魁	元甫
董宋儒	董	宋儒	應宿
梁銓	梁	銓	叔衡
鄭一鵬	鄭	一鵬	廷舉
朱星耀	朱	星耀	應春
李光祖	李	光祖	克肖
郭陞	郭	陞	文晉
顧汝學	顧	汝學	思益
薛繼茂	薛	繼茂	德茂
張貞觀	張	貞觀	維誠
時偕行	時	偕行	汝徤
夏之臣	夏	之臣	贊禹
黃中色	黃	中色	元采
吳龍徵	吳	龍徵	應圖
徐常吉	徐	常吉	士彰
盧一誠	盧	一誠	誠之
黃騰春	黃	騰春	序賓
孟養浩	孟	養浩	義甫
馬薖	馬	薖	允寬
沈之唫	沈	之唫	性甫
林熙春	林	熙春	志和
劉會	劉	會	逢甲
羅朝國	羅	朝國	惟禎
李芳先	李	芳先	元秀
徐學聚	徐	學聚	敬輿
汪煥	汪	煥	文仲
盧龍雲	盧	龍雲	少從
劉斯濯	劉	斯濯	儒新
宋興祖	宋	興祖	汝傑
胡三省	胡	三省	子唯
周嘉賓	周	嘉賓	仲召
戴朝用	戴	朝用	孝升
曹繼孝	曹	繼孝	達卿
何應奇	何	應奇	遇夫
董國光	董	國光	士彥
姚思仁 	姚	思仁 	善長
杜華先	杜	華先	孝卿
趙世顯	趙	世顯	仁甫
饒崙	饒	崙	廷宗
盧大中	盧	大中	子致
張光緒	張	光緒	孝伯
來三聘	來	三聘	任卿
牛應元	牛	應元	子仁
鍾若休	鍾	若休	于集
陳一言 	陳	一言 	愚悃
陳汝麟	陳	汝麟	仁夫
張常	張	常	以綱
陳舜仁	陳	舜仁	淳甫
廖道充	廖	道充	見可
佘夢鯉	佘	夢鯉	有達
何選	何	選	靖卿
茅國縉	茅	國縉	薦卿
于永清	于	永清	源潔
賈名儒	賈	名儒	聘甫
董道醇	董	道醇	子儒
朱苕	朱	苕	仲魚
連標	連	標	孟準
張璧	張	璧	世良
魯點	魯	點	子與
袁一驥	袁	一驥	道遠
李商耕	李	商耕	莘聘
李春開　	李	春開　	幼實
劉汝康	劉	汝康	濟甫
彭徤吾	彭	徤吾	象玄
陳錦	陳	錦	端實
孫承謨	孫	承謨	顯卿
趙世德	趙	世德	允求
樊養鳳	樊	養鳳	時鳴
程朝京	程	朝京	康侯
喬光岳	喬	光岳	會貞
龔聞道	龔	聞道	信夫
程訓	程	訓	君誨
李杜才	李	杜才	鳴儒
蔡肇慶	蔡	肇慶	以祥
湯顯祖	湯	顯祖	義仍
徐應聘	徐	應聘	伯衡
林寅賓	林	寅賓	爾亮
曹一元	曹	一元	慎夫
梅國樓	梅	國樓	公岑
聶應科	聶	應科	廷傑
嚴貞度	嚴	貞度	茂肅
錢景超	錢	景超	世功
熊元	熊	元	子貞
張宗載	張	宗載	一寧
李甲	李	甲	伯始
徐圖	徐	圖	君猷
趙學仕	趙	學仕	信甫
李用中	李	用中	舜智
曹學程	曹	學程	希明
趙任	趙	任	仁甫
樊玉衡	樊	玉衡	欽之
涂文煥	涂	文煥	本兄
錢夣得	錢	夣得	國賢
鄧宗齡	鄧	宗齡	子振
劉大武	劉	大武	定甫
姜應麟	姜	應麟	子文
杜廕	杜	廕	舜延
陳勗	陳	勗	典伯
張廷相	張	廷相	以忠
雒于仁	雒	于仁	依仲
賈尚志	賈	尚志	士事
田勸	田	勸	作民
郭如川	郭	如川	元至
劉宇	劉	宇	伯大
李盛時	李	盛時	伯行
許一敬	許	一敬	思禮
劉三才	劉	三才	子極
李應策	李	應策	獻可
何汝岱	何	汝岱	宗卿
蔡彭	蔡	彭	敦賢
黃廷寶	黃	廷寶	善卿
汪道亨	汪	道亨	汝立
林材	林	材	謹任
李以唐	李	以唐	伯堯
李炳	李	炳	文之
黃應聘	黃	應聘	三甫
劉養志	劉	養志	希尹
雍之可	雍	之可	子敬
常心	常	心	幼若
楊應中	楊	應中	子貞
陳楚產	陳	楚產	悅道
程試	程	試	子躍
邢紹美	邢	紹美	有嘉
何偉	何	偉	汝器
文運熙	文	運熙	時雍
屠如虹	屠	如虹	見辰
徐準	徐	準	子式
黃萼	黃	萼	國英
王堦	王	堦	震吉
劉思瑜	劉	思瑜	伯美
鄭國俊	鄭	國俊	君籲
李為芝	李	為芝	明瑞
岳萬階	岳	萬階	允升
蔣薦	蔣	薦	君受
梁雲龍	梁	雲龍	會可
王祿兆	王	祿兆	惟功
張庚	張	庚	長卿
劉黃裳	劉	黃裳	玄子
袁黃	袁	黃	坤儀
閔文卿	閔	文卿	廷昭
彭烊	彭	烊	冶金
羅大紘	羅	大紘	公廓
羅緄	羅	緄	承文
陸大成	陸	大成	集甫
楊耿光	楊	耿光	覲之
宋棠	宋	棠	子澤
顧時化	顧	時化	雨之
韓文	韓	文	原質
葉煒	葉	煒	汝充
任僖	任	僖	士安
張守頤	張	守頤	貞卿
錢允元	錢	允元	虞佐
唐興仁	唐	興仁	德甫
吳期炤	吳	期炤	闇夫
高巖	高	巖	魯瞻
王如堅	王	如堅	石夫
毛壽南	毛	壽南	宇徵
盛世翼	盛	世翼	以忠
李脩吉	李	脩吉	允敬
諸壽賢	諸	壽賢	延之
李楠	李	楠	伯南
李文熙	李	文熙	道光
張翰	張	翰	文華
蓋國士	蓋	國士	懋賢
樊東謨	樊	東謨	伯明
彭好古	彭	好古	伯籛
顧允元	顧	允元	懋善
李賦秀	李	賦秀	汝毓
耿隨龍	耿	隨龍	舜言
張正學	張	正學	可宗
夏國寶	夏	國寶	惟善
曾開泰	曾	開泰	太耒
邵鍪	邵	鍪	麟武
宋應和	宋	應和	道達
劉道亨	劉	道亨	時濟
黃之俊	黃	之俊	君籲
李秩	李	秩	序甫
韓魏	韓	魏	晉勳
鍾允復	鍾	允復	大亨
楊伯柯	楊	伯柯	直甫
高環	高	環	循卿
楊應時	楊	應時	際甫
何出圖	何	出圖	啟文
楊道賓	楊	道賓	惟彥
張國紀	張	國紀	子振
徐任道	徐	任道	仁卿
顏文選	顏	文選	巽之
綦才	綦	才	色鋤
盛稔	盛	稔	伯豐
王宗蓁	王	宗蓁	時榮
陸經	陸	經	載道
葉麃	葉	麃	以文
岑應春	岑	應春	繹仁
梁賛化	梁	賛化	翼卿
耿爭光	耿	爭光	爾遜
傅履階	傅	履階	則及
方大美	方	大美	思濟
婁希亮	婁	希亮	道弼
李承槐	李	承槐	應揆
王就學	王	就學	所敬
潘大復	潘	大復	徵復
吳之望	吳	之望	民表
黃大節	黃	大節	思立
侯康	侯	康	汝錫
陳惇臨	陳	惇臨	彥莊
洪敷誥	洪	敷誥	天章
姚尚德	姚	尚德	伯容
宋薦	宋	薦	子朝
邢懋敬	邢	懋敬	一卿
水卿謨	水	卿謨	禹陳
費必興	費	必興	應祥
李元實	李	元實	士貞
閔遠慶	閔	遠慶	基厚
劉三英	劉	三英	邦彥
王立賢	王	立賢	聘卿
林茂桂	林	茂桂	德芬
林欲廈	林	欲廈	從奐
張允升	張	允升	大猷
龔道立	龔	道立	應身
周嗣哲	周	嗣哲	宇明
張應鳳	張	應鳳	于梧
劉曰梧	劉	曰梧	陽生
甯嘉猷	甯	嘉猷	君獻
朱誥	朱	誥	巽甫
傅慶貽	傅	慶貽	有積
張時脩	張	時脩	德甫
林守信	林	守信	士孚
李守貞	李	守貞	原智
曹光祚	曹	光祚	伯延
曹代蕭	曹	代蕭	畫一
蕭重望	蕭	重望	仰卿
吳尚友	吳	尚友	元德
蘇舜臣	蘇	舜臣	哲甫
秦鄰晉	秦	鄰晉	汝睦
錢士鰲	錢	士鰲	季梁
康夢相	康	夢相	予賚
王𨤲土	王	𨤲土	以慶
林繼𢖍	林	繼𢖍	惟中
李沂	李	沂	景魯
王都	王	都	邦畿
余炶	余	炶	體易
楊光訓	楊	光訓	汝若
曹大咸	曹	大咸	元和
王建中	王	建中	銘新
劉大文	劉	大文	敬甫
蔡淑逵	蔡	淑逵	子正
陸應川	陸	應川	汝濟
張時顯	張	時顯	仁卿
于天經	于	天經	克孝
陳道亨	陳	道亨	孟起
徐堯莘	徐	堯莘	汝聘
任道學	任	道學	用予
張應槐	張	應槐	汝植
蕭奇烋	蕭	奇烋	懋揚
江鍾廉	江	鍾廉	介季
彭錫命	彭	錫命	君寵
唐文獻	唐	文獻	元徵
侯廷珮	侯	廷珮	長德
紫堯年	紫	堯年	欽甫
張斗	張	斗	文光
鄭舉	鄭	舉	世用
章憲文	章	憲文	公覲
趙家相	趙	家相	熙載
許汝魁	許	汝魁	真甫
延論	延	論	元訥
曾光魯	曾	光魯	于魯
吳文燦	吳	文燦	元質
李維標	李	維標	本立
趙鍾岷	趙	鍾岷	望甫
王之翰	王	之翰	季楨
吳中明	吳	中明	知常
倪思益	倪	思益	受卿
曾礪	曾	礪	守鈍
張輔之	張	輔之	爾贊
傅道統	傅	道統	寅脩
郭如魯	郭	如魯	唯一
顧龍禎	顧	龍禎	翼卿
高進孝	高	進孝	遂忠
禇國賢	禇	國賢	徵羨
吳崇禮	吳	崇禮	彬卿
劉道隆	劉	道隆	麟原
方元彥	方	元彥	士美
龔文選	龔	文選	時舉
楊遇	楊	遇	惟良
孫繼有	孫	繼有	恒叔
陳大道	陳	大道	靖卿
陳容淳	陳	容淳	之初
王嘉賓	王	嘉賓	國賢
浦士衡	浦	士衡	殷卿
吳道光	吳	道光	孚伯
屈燦	屈	燦	文斗
吳應明	吳	應明	仲卿
汪應泰	汪	應泰	爾通
崔邦亮	崔	邦亮	德嚴
陳果	陳	果	稚碩
王圖	王	圖	則之
尹從淑	尹	從淑	道傳
徐庭綬	徐	庭綬	公綰
趙思敏	趙	思敏	學甫
鄭瑞星	鄭	瑞星	廷奎
馬邦良	馬	邦良	君遂
江環	江	環	啟運
洪澄源	洪	澄源	子定
董肇胤	董	肇胤	善□
張德明	張	德明	子經
王同休	王	同休	揚甫
林承芳	林	承芳	開先
葛孔明	葛	孔明	皓尗
黃道月	黃	道月	德卿
留敬臣	留	敬臣	懋德
杜允繼	杜	允繼	惟序
林震	林	震	宙侯
鄧應祈	鄧	應祈	永卿
岳九逵	岳	九逵	季達
吳楷	吳	楷	允式
梁祖齡	梁	祖齡	紹首
熊密	熊	密	子縝
張集義	張	集義	德宜
徐元正	徐	元正	景文
薛三才	薛	三才	中孺
程子釴	程	子釴	鼎輔
韓學信	韓	學信	復之
葉重第	葉	重第	道及
景章	景	章	速卿
陳所職	陳	所職	爾司
王孟煦	王	孟煦	育明
陳于王	陳	于王	伯襄
徐兆魁	徐	兆魁	策廷
李宗延	李	宗延	景喆
何淳之	何	淳之	仲雅
熊宇奇	熊	宇奇	正子
鄭得書	鄭	得書	子讀
羅應斗	羅	應斗	光射
周玄暐	周	玄暐	叔茂
徐存德	徐	存德	恒甫
傅商弼	傅	商弼	汝遇
何喬遠	何	喬遠	稚孝
彭遵古	彭	遵古	季籛
李大武	李	大武	仲吉
林祖述	林	祖述	道卿
范以淑	范	以淑	汝聞
任萬化	任	萬化	贊之
沈瓚	沈	瓚	孝通
劉夢周	劉	夢周	東化
王之彥	王	之彥	仲美
黃縉	黃	縉	拱宸
趙完璧	趙	完璧	念儆
徐成楚	徐	成楚	光南
趙夢麟	趙	夢麟	季兆
傅肖形	傅	肖形	夢徵
唐斯盛	唐	斯盛	應中
謝朝佐	謝	朝佐	良輔
劉訥	劉	訥	仁寰
石岩	石	岩	伯瞻
何太庚	何	太庚	吉父
王志	王	志	汝學
雷元善	雷	元善	汝仁
陳蘊	陳	蘊	上行
周如綸	周	如綸	叔音
彭應捷	彭	應捷	讓甫
韓擢	韓	擢	叔捷
許子偉	許	子偉	雲程
周應鏊	周	應鏊	如春
吳弘濟	吳	弘濟	春陽
林汝詔	林	汝詔	君綸
李璣	李	璣	時仰
朱士佳	朱	士佳	邦題
林璣	林	璣	光仲
劉弘寶	劉	弘寶	公可
熊鳴夏	熊	鳴夏	心禹
吳洪績	吳	洪績	崇緒
常道立	常	道立	孟庸
蔡守愚	蔡	守愚	體言
柳佐	柳	佐	宗相
鄒德泳	鄒	德泳	汝聖
陳洪烈	陳	洪烈	元勛
顧允成	顧	允成	季時
張一棟	張	一棟	任甫
包應登	包	應登	稺升
王希夔	王	希夔	子和
袁光宇	袁	光宇	元讓
田立家	田	立家	正國
盧傳元	盧	傳元	貞復
林夢鶴	林	夢鶴	獻禎
陳濂	陳	濂	道源
魏諤	魏	諤	直卿
查允元	查	允元	仁卿
袁宗道	袁	宗道	伯修
張弋	張	弋	用弛
朱爵	朱	爵	仲修
司憲	司	憲	憲國
蕭雲舉	蕭	雲舉	允升
韓策	韓	策	獻之
吳鴻洙	吳	鴻洙	文衢
周著	周	著	誠子
楊宏科	楊	宏科	融博
冀體	冀	體	肖甫
陳遴瑋	陳	遴瑋	玉甫
弋鶴	弋	鶴	鳴臯
劉以煥	劉	以煥	章卿
李光輝	李	光輝	文徵
王嘉謨	王	嘉謨	伯侖
姜仲軾	姜	仲軾	希蘇
鍾萬祿	鍾	萬祿	懋功
嚴正邦	嚴	正邦	範先
于仕廉	于	仕廉	元貞
鄧美政	鄧	美政	尚德
唐世堯	唐	世堯	見甫
邢有卞	邢	有卞	惟慎
王士昌	王	士昌	永叔
陳鳴華	陳	鳴華	誠甫
徐夢麟	徐	夢麟	惟仁
郭應時	郭	應時	行之
孫承榮	孫	承榮	元錫
魏養蒙	魏	養蒙	以貞
張濤	張	濤	原裕
王佐	王	佐	襄甫
陳義	陳	義	克宜
蔡淮	蔡	淮	弘甫
龔懋	龔	懋	益孫
張泮	張	泮	有源
丁元薦	丁	元薦	長孺
梅守峻	梅	守峻	貞卿
李伯華	李	伯華	允實
陸埜	陸	埜	子聞
沈天啟	沈	天啟	生予
張令聞	張	令聞	叔闇
顧雲鳳	顧	雲鳳	伯翔
王德完	王	德完	子醇
李杜	李	杜	汝唐
劉為楫	劉	為楫	時用
劉源澄	劉	源澄	清之
聶世潤	聶	世潤	德甫
陳所問	陳	所問	爾虛
呂兆熊	呂	兆熊	宗望
蔡思穆	蔡	思穆	夢敬
曹愈參	曹	愈參	右清
李日茂	李	日茂	文華
郭俊	郭	俊	公籲
楊廷蘭	楊	廷蘭	秀夫
歐陽勁	歐陽	勁	懋節
朱昌	朱	昌	泰甫
金繼震	金	繼震	長卿
陶明禮	陶	明禮	天產
陳所見	陳	所見	實是
陳應龍	陳	應龍	德見
伍文煥	伍	文煥	在中
曹璜	曹	璜	維章
夏爋	夏	爋	汝翼
高從禮	高	從禮	質甫
楊繼先	楊	繼先	思孝
趙世典	趙	世典	伯循
王一魁	王	一魁	斗垣
艾維新	艾	維新	希周
田大益	田	大益	或損
蔣行義	蔣	行義	思弼
黃汝良	黃	汝良	明起
馬思恭	馬	思恭	君篤
顧紳	顧	紳	知非
王道正	王	道正	惟德
王一鳴	王	一鳴	伯固
項德禎	項	德禎	廷堅
戴燝	戴	燝	亨融
韓范	韓	范	思兼
李汝珪	李	汝珪	元錫
袁茂英	袁	茂英	君學
安希范	安	希范	小范
韓邦域	韓	邦域	仕廣
胡克儉	胡	克儉	我虛
李養質	李	養質	從樸
張和中	張	和中	可育
祝以豳	祝	以豳	孟劉
李啟美	李	啟美	應成
李起元	李	起元	惺原
黃承玄	黃	承玄	履常
樊鎔	樊	鎔	汝陶
盧明諏	盧	明諏	君教
吳應賓	吳	應賓	尚之
沈思充	沈	思充	孟符
馮養志	馮	養志	若曾
周獻臣	周	獻臣	窽六
趙標	趙	標	貞甫
司諫	司	諫	信夫
全天敘	全	天敘	幼度
周之鼎	周	之鼎	定甫
舒弘志	舒	弘志	孺立
劉憲寵	劉	憲寵	抑之
徐之孟	徐	之孟	□
顏宇坪	顏	宇坪	□
王玠	王	玠	必彥
郭士吉	郭	士吉	希參
周琦	周	琦	□伯
張鶴鳴	張	鶴鳴	
宋師程	宋	師程	
李原中	李	原中	君時
陳世恩	陳	世恩	
洪其道	洪	其道	
劉湧	劉	湧	
曹鼐 	曹	鼐 	萬鍾
趙恢	趙	恢	汝弘
鍾復	鍾	復	弘彰
梁宏	梁	宏	士遠
高旭	高	旭	時旭
蘇洪	蘇	洪	大用
舒曈 	舒	曈 	仲曦
鄭亮	鄭	亮	汝明
馬諒	馬	諒	諒
石瑁	石	瑁	□之
林灝 	林	灝 	弘端
劉益	劉	益	宗益
劉禎	劉	禎	□慶
蔣銘  	蔣	銘  	公維
范琮 	范	琮 	禎彥
王弼 	王	弼 	廷□
李詢 	李	詢 	□同
沈譓	沈	譓	□哲
林茂	林	茂	茂叔
王用 	王	用 	□賓
黃回祖 	黃	回祖 	□顏
傅綱 	傅	綱 	大常
蔣箴	蔣	箴	良規
李賢 	李	賢 	原德
盧彬	盧	彬	□□
黃瓚 	黃	瓚 	時貴
吳方大 	吳	方大 	
黃瓚 	黃	瓚 	□璋
張彝 	張	彝 	□則
程式	程	式	□□
俞僴	俞	僴	弘毅
高奉 	高	奉 	□敬
尹昌	尹	昌	禎行
方迪	方	迪	從□
陸瑜 	陸	瑜 	廷玉
徐珵 	徐	珵 	元玉
劉哲 	劉	哲 	□哲
吳高 	吳	高 	□□
梁亨 	梁	亨 	□□
項文曜 	項	文曜 	應昌
侯潤 	侯	潤 	仲璣
鄒來學 	鄒	來學 	時敏
竺淵  	竺	淵  	□深
劉綱 	劉	綱 	□紀
侯臣	侯	臣	仲□
陸謙光 	陸	謙光 	全吉
鮑輝 	鮑	輝 	□□
王鐸	王	鐸	□振
宋雍 	宋	雍 	□□
李紹 	李	紹 	克□
陸矩 	陸	矩 	仲興
鄭悠	鄭	悠	□大
姜洪 	姜	洪 	□□
宋懷	宋	懷	士皐
張用瀚	張	用瀚	志本
譚溥	譚	溥	□□
蘇肄 	蘇	肄 	習□
楊鐸	楊	鐸	□□
趙智 	趙	智 	□□
祝暹	祝	暹	□□
趙迪 	趙	迪 	□□
何瑄 	何	瑄 	孟煥
曾翬 	曾	翬 	□□
張傑 	張	傑 	□□
謝磷 	謝	磷 	利□
盧欽 	盧	欽 	敬之
李庭脩 	李	庭脩 	□□
馬嵩	馬	嵩	□□
蕭璁 	蕭	璁 	常□
潘洪	潘	洪	克容
彭祥	彭	祥	□□
王瑨 	王	瑨 	□□
梅森	梅	森	□芳
封祥 	封	祥 	慶和
陳金 	陳	金 	□□
王亮	王	亮	□□
趙徵	趙	徵	□□
倪端	倪	端	文□
何史訓  	何	史訓  	□□
金輔伯	金	輔伯	□□
吳昇 	吳	昇 	亨曦
張固 	張	固 	公正
陳睿 	陳	睿 	文聰
張茂 	張	茂 	□方
汪敬 	汪	敬 	益謙
張敏 	張	敏 	時勉
彭彰	彭	彰	□明
陳璞	陳	璞	□□
廖恂 	廖	恂 	仲孚
唐世良 	唐	世良 	得章
高耿	高	耿	□□
李亨 	李	亨 	□□
馬豫	馬	豫	彥安
朱衡	朱	衡	永平
孟鑑 	孟	鑑 	克明
楊玉 	楊	玉 	用□
方員 	方	員 	懋規
王頤	王	頤	養正
高峯	高	峯	□□
林應元	林	應元	漢城
王愛 	王	愛 	澤容
李本緯	李	本緯	淶玉
楊惟治	楊	惟治	同野 
金汝升	金	汝升	巽含
蕭淳	蕭	淳	念野
高攀枝	高	攀枝	交□
王樂善	王	樂善	西□
李應魁	李	應魁	鵬所
王國翼	王	國翼	翀宇
蔡夢齊	蔡	夢齊	覺我
管學畏	管	學畏	志道
陳萬策	陳	萬策	麟臺
王一之	王	一之	紹杏
劉生中	劉	生中	性宇
楊廷愛 	楊	廷愛 	思所
石九奏	石	九奏	四如
王應元	王	應元	石臺
聶雲翰	聶	雲翰	化南
李必達	李	必達	孚宇
冀光祚	冀	光祚	奕軒
董復享	董	復享	太初　
李從心	李	從心	介石
王永光	王	永光	射斗
沈鳳翔	沈	鳳翔	□□
厲昌謨	厲	昌謨	望所
張應望	張	應望	凝益
管廷節	管	廷節	凝初
金士衡	金	士衡	昆源
顧天埈	顧	天埈	鴻菴
柴大履	柴	大履	行素
陸化淳	陸	化淳	□源
翁憲祥 	翁	憲祥 	完虛
吳默	吳	默	因之
顧自植	顧	自植	含素
李名芳	李	名芳	昌海
王在晉	王	在晉	岵雲
唐之屏 	唐	之屏 	曾城
沈時來	沈	時來	石樓
楊繼禮	楊	繼禮	石□
夏景華	夏	景華	凝初 
李尚衮	李	尚衮	南滙
朱家法	朱	家法	半石
高承祚	高	承祚	岳峯
劉純仁	劉	純仁	景范
胡澄	胡	澄	玄海
周士英	周	士英	惺莪
吳海鏊	吳	海鏊	霽陽
堵維垣	堵	維垣	太冲
顧言	顧	言	中瑜
張履正	張	履正	
湯兆京	湯	兆京	質叄
鍾鳴陛	鍾	鳴陛	咸亭
丁鴻陽	丁	鴻陽	衡岳
馮體乾	馮	體乾	念純
史弼	史	弼	企愚
竇于偁	竇	于偁	進南
馮應京	馮	應京	慕岡
徐來儀	徐	來儀	蒼水
楊武烈	楊	武烈	澹中
吳士奇	吳	士奇	廷洲
胡玠	胡	玠	北岳
汪鳴鸞	汪	鳴鸞	咸池
余懋恆	余	懋恆	少原
謝存仁	謝	存仁	太涵
高登明	高	登明	東始
胡國鑑	胡	國鑑	曜眾
王文爟	王	文爟	及岩
張應泰	張	應泰	東山
崔廷健	崔	廷健	軒鼎
潘譢	潘	譢	梅岩
劉伯輝	劉	伯輝	皖春
楊材	楊	材	□生
吳用先	吳	用先	本如
金忠士	金	忠士	□暢
賈巖	賈	巖	泰石
姚文蔚	姚	文蔚	養谷
王廷錫	王	廷錫	懷我
沈朝煥	沈	朝煥	太玄
俞思冲	俞	思冲	曕白
楊廷筠	楊	廷筠	淇園
朱與翹	朱	與翹	惺復
高鎮位	高	鎮位	秦槃
施爾志 	施	爾志 	荊塗
徐必達	徐	必達	立伏
李日華	李	日華	九□
岳和聲	岳	和聲	石梁
范應賓	范	應賓	
陳懿典 	陳	懿典 	如□
夏九鼎	夏	九鼎	璞叄
鍾兆斗	鍾	兆斗	乾所
李在公	李	在公	養白
沈㴶	沈	㴶	銘□
沈演	沈	演	河山
施浚明	施	浚明	二華
潘士達	潘	士達	完璞
嚴廷儀	嚴	廷儀	景苔
丁浚	丁	浚	克源
沈裕	沈	裕	懷菴
朱燾	朱	燾	穀城
王福徵	王	福徵	瀛橋
陳一恪	陳	一恪	大庭
沈茂榮	沈	茂榮	春寰
劉憲寵	劉	憲寵	行素
馮烶	馮	烶	景貞
馮若舒	馮	若舒	漢醇
王應吉	王	應吉	禦谿
陳美	陳	美	冲宇
朱敬循	朱	敬循	石門
朱錦	朱	錦	恕銘
朱爕元	朱	爕元	恆岳
孫如游	孫	如游	鑑湖
陳治本	陳	治本	簾岳
陳治則	陳	治則	簾崖
梁廷卿	梁	廷卿	見□
徐可求	徐	可求	觀我
徐公敬	徐	公敬	濱麓
毛一瓚	毛	一瓚	肖環
喻言興	喻	言興	順中
舒曰敬	舒	曰敬	碣石
羅相	羅	相	澄溪　
饒景擢	饒	景擢	崑國
徐應鶴	徐	應鶴	鳴隼
熊鍾文 	熊	鍾文 	寧野
陳維春	陳	維春	如□
毛志尹	毛	志尹	思近
劉一焜	劉	一焜	石閭
徐夢暘	徐	夢暘	懷劬
姚善	姚	善	性宇
朱一桂	朱	一桂	月樵
陳幼良	陳	幼良	宇初
王演疇	王	演疇	震澤
周訓	周	訓	仰謙
周曰庠	周	曰庠	文所
曹如海	曹	如海	敬元
徐仲佳	徐	仲佳	韋承
熊鏌	熊	鏌	中宇
曹皋	曹	皋	見虞
蕭椿	蕭	椿	曙房
劉孔當	劉	孔當	喜□
李開春	李	開春	真吾
趙應選　	趙	應選　	太初
胡大成	胡	大成	澹源
彭自新	彭	自新	祖銘
鄧原岳	鄧	原岳	翠屏
翁正春	翁	正春	青陽
李文奎	李	文奎	聚五
謝肇淛	謝	肇淛	武林
陳振揚	陳	振揚	清波
蘇守一	蘇	守一	悟台
史繼階	史	繼階	聯雲　
林學曾	林	學曾	省身
蔣光彥	蔣	光彥	九覲
洪啟睿	洪	啟睿	
蘇守庶	蘇	守庶	
李叔元	李	叔元	鹿巢
蘇茂相	蘇	茂相	石本
洪有助	洪	有助	遜叄
江中楠	江	中楠	玉林
丁啟睿	丁	啟睿	硩初
胡明佐	胡	明佐	拱柱
鄒希賢	鄒	希賢	星門
盧廷選	盧	廷選	真常
徐大紳	徐	大紳	翰明
戴以讓	戴	以讓	振宇
胡賓墀	胡	賓墀	見龍
李甫文	李	甫文	□南
楊一葵	楊	一葵	致五
蘇民俊	蘇	民俊	遴廷
連繼芳	連	繼芳	榮州
盧碩	盧	碩	與軒
倪大器	倪	大器	崧山
高克正	高	克正	瑞宇
陳臣表	陳	臣表	擎南
朱文卿	朱	文卿	斗墟
劉廷桂　	劉	廷桂　	初陽
孫鋐	孫	鋐	元涵
黃士吉　	黃	士吉　	岷嶽
李之皞	李	之皞	華堯
熊寅	熊	寅	念塘
朱一龍	朱	一龍	虞言
周之輪	周	之輪	景玉
柯維蓁	柯	維蓁	峴賓
湯沐	湯	沐	鄖隆
黃蘭芳	黃	蘭芳	綺石
余心純	余	心純	葵明
吳士瑞	吳	士瑞	我雲
楊逢時	楊	逢時	
袁宏道	袁	宏道	六休　
田大年	田	大年	東明
姜性	姜	性	切蒙
張存意	張	存意	覺自
張嘉言	張	嘉言	寰應
李騰芳	李	騰芳	四履
蔡承甲	蔡	承甲	青沙
江應科	江	應科	祿蘿
楊正苾	楊	正苾	惺弦
屈之乘	屈	之乘	鍾湘
張鶴鳴	張	鶴鳴	鳳臯
張同德	張	同德	明寰
張敦化	張	敦化	太初
李來命	李	來命	承松
周六書	周	六書	絕叄
李希召	李	希召	太宇
張寧	張	寧	載宇
宋一韓	宋	一韓	國田
李維翰	李	維翰	□棠
袁和	袁	和	節吾　
楊性魯	楊	性魯	誠宇
喬允升	喬	允升	鶴臯
何際可	何	際可	海崙
徐守謙	徐	守謙	涵溟
陳民志	陳	民志	望白
李雲鵠	李	雲鵠	黃羽
馬從龍	馬	從龍	盧生
李之芬	李	之芬	德馨
李克敏	李	克敏	湛寰
汪若霖	汪	若霖	霽寰
黃熖	黃	熖	明寰
段猷顯	段	猷顯	青園
沈聽之	沈	聽之	心聞
陳宁	陳	宁	葵庵
劉亮采	劉	亮采	□函
穆深	穆	深	桂陽
張延登	張	延登	華東
畢自嚴　	畢	自嚴　	白陽
蒲生汶	蒲	生汶	若濁
張篤敬	張	篤敬	銘紳
耿庭栢　	耿	庭栢　	華平　
王象節	王	象節	翼吾
康丕揚	康	丕揚	馴漢
張問行	張	問行	見衡
楊檟	楊	檟	毓奇
關揚	關	揚	明吾
葉敬愿	葉	敬愿	欽□
潘榛	潘	榛	麓源
張宗孔	張	宗孔	河濱
武之大	武	之大	連城
龐時雍	龐	時雍	堯封
楊洵	楊	洵	崑源
檀芳邃	檀	芳邃	絍谷
李本固	李	本固	震門　
桑學夔	桑	學夔	世澄
張三極	張	三極	襄城
張敦善	張	敦善	崇菴
馬應龍	馬	應龍	北溟
馬從龍	馬	從龍	見素
臧爾勸	臧	爾勸	石□
王用謨	王	用謨	明吾
潘國重	潘	國重	玉衡
李景登	李	景登	瀧川
馬維駰	馬	維駰	碓原
鄭友周	鄭	友周	毅軒
石琳	石	琳	崑山
李炳	李	炳	本陽
王編	王	編	嗣鳳
朱繪	朱	繪	完初　
史學遷	史	學遷	武林
韓爌	韓	爌	象雲
喬應甲	喬	應甲	儆我
王國瑚	王	國瑚	珍吾
景明	景	明	中宇
杜思望	杜	思望	友山
曹于汴	曹	于汴	真予
陶登	陶	登	雲階
史允中	史	允中	心源
張爾基	張	爾基	洪源
周一梧	周	一梧	懷白　
孫居相	孫	居相	洪陽
張五典	張	五典	海虹
郭嗣煥	郭	嗣煥	憲吾　
王家礎	王	家礎	□銘
梁隆吉	梁	隆吉	禎宇
趙之翰	趙	之翰	藎菴
薛芳	薛	芳	心亭
張養才	張	養才	樂吾
咎雲鶴	咎	雲鶴	鳴宇
怡愉	怡	愉	慕溪
劉九經	劉	九經	□吾
閻溥	閻	溥	鳳棲
趙邦清　	趙	邦清　	乾所
王喻	王	喻	□山
趙可教	趙	可教	心軒
周仲士	周	仲士	純所
王大合　	王	大合　	六宇
岳虞詢	岳	虞詢	四門
杜日章	杜	日章	錦吾
黃緯	黃	緯	續軒
楊松年	楊	松年	崑林
張聯奎	張	聯奎	映宇
錢承恩	錢	承恩	震宇
何起升	何	起升	本江
范岷彚	范	岷彚	念湖
鄒廷彥	鄒	廷彥	念劬
倪斯蕙	倪	斯蕙	禹同
廖如龍	廖	如龍	虛我
卞承憲　	卞	承憲　	惺銘
李作舟	李	作舟	三溪
熊應占	熊	應占	□□
佘自強	佘	自強	健吾
郭維禎	郭	維禎	華中
何熊祥	何	熊祥	
梁民相　	梁	民相　	食泉
張初旦	張	初旦	□吾
李延大	李	延大	保赤
陳元勳	陳	元勳	屬謙
蔣之秀	蔣	之秀	鍾岳
賈毓祥	賈	毓祥	元冲
王所用	王	所用	□□
王湯孫	王	湯孫	稚誕
馮三元	馮	三元	□□
鄒之易	鄒	之易	爾時
韓炳衡	韓	炳衡	□□
張庭玉	張	庭玉	汝光
唐公靖	唐	公靖	君平
沈有則	沈	有則	士範
趙昌期	趙	昌期	當世
陳士章	陳	士章	成甫
李士高	李	士高	孟乾
劉宇曜	劉	宇曜	叔定
郭志仁	郭	志仁	元甫
岳駿聲	岳	駿聲	季有
張紹魁	張	紹魁	天衢
王順行	王	順行	率之
尹嘉賔	尹	嘉賔	孔昭
徐楠	徐	楠	柱明
吳奕	吳	奕	世于
喬時敏	喬	時敏	君求
鄒之麟	鄒	之麟	臣虎
陳儀	陳	儀	用吉
金汝嘉	金	汝嘉	無美
史要典	史	要典	維世
汪泗論	汪	泗論	自魯
陶珽	陶	珽	穉圭
區龍禎	區	龍禎	象先
莊起元	莊	起元	中孺
馬斯和	馬	斯和	動□
楊鐸	楊	鐸	斯覺
祝可仕	祝	可仕	孟型
朱大啟	朱	大啟	君輿
張僎	張	僎	公朴
荊時薦	荊	時薦	伯鶚
秦繼宗	秦	繼宗	敬伯
洪覲光	洪	覲光	共乂
李篤培	李	篤培	汝植
任芳鑑	任	芳鑑	馨明
朱明時	朱	明時	承六
趙鵬程	趙	鵬程	伯翔
蕭定	蕭	定	彥得
王家相	王	家相	維樞
馬呈德	馬	呈德	君馭
陶鎔	陶	鎔	去非
李廷檳	李	廷檳	啟龍
陳維鼎	陳	維鼎	九一
吳奇逢	吳	奇逢	當時
劉行義	劉	行義	天達
莊廷臣	莊	廷臣	龍祥
胡舜㣧	胡	舜㣧	明祚
侯震暘	侯	震暘	得一
包鴻逵	包	鴻逵	儀甫
歐陽照	歐陽	照	文白
張慎言	張	慎言	金銘 
潘大儒	潘	大儒	漢門
劉述祖	劉	述祖	善夫
田珍	田	珍	子□
鄒人昌	鄒	人昌	天策
文翔鳳	文	翔鳳	天瑞
董翼	董	翼	伯隣
張國銳	張	國銳	貞子
王世蔭	王	世蔭	公兆
周訓	周	訓	若甫
李純元	李	純元	長叔
賀萬祚	賀	萬祚	孝延
張泰禎	張	泰禎	宇全
馮聖世	馮	聖世	道昌
黃卷	黃	卷	舒之
陳琦	陳	琦	國偉
管應律	管	應律	正之
熊維卿	熊	維卿	以世
王聘	王	聘	以珍
孫昌裔	孫	昌裔	子長
歐從雲	歐	從雲	天孚
白竹	白	竹	長倩
杜熙陽	杜	熙陽	曜均
徐培植	徐	培植	彥成
石維嶽	石	維嶽	大治
周士皐	周	士皐	子寅
商胤祥	商	胤祥	咸一
吳其貴	吳	其貴	偉爵
蔡邦潘	蔡	邦潘	于藩
張論	張	論	建白
唐中醒	唐	中醒	亞先
朱國盛	朱	國盛	敬韜
夏嘉遇	夏	嘉遇	正甫
曾孔遇	曾	孔遇	惟心
郭湸	郭	湸	季□
賈允元	賈	允元	善長
張夢鯨	張	夢鯨	仲鱗
吳廷雲	吳	廷雲	叔韓
李乃蘭	李	乃蘭	汝佩
余合中	余	合中	子嘉
葛如麟	葛	如麟	子仁
賀仲軾	賀	仲軾	
王命新	王	命新	又新
吳瑞徵	吳	瑞徵	仲庚
吳之甲	吳	之甲	元秉
謝渭	謝	渭	道游
鄭懋緯	鄭	懋緯	承聚
程策	程	策	獻可
曹煃	曹	煃	在魯
李躍龍	李	躍龍	抱一
丘兆麟	丘	兆麟	毛信
徐日久	徐	日久	子卿
馬之騏	馬	之騏	時良
朱欽相	朱	欽相	懋忠
郭興治	郭	興治	匡世
江秉謙	江	秉謙	兆霖
于之大	于	之大	游伯
徐騰芳	徐	騰芳	雲卿
趙于逵	趙	于逵	羽孟
高棟	高	棟	隆吉
施樑	施	樑	仔吾
周文煥	周	文煥	憲章
朱明昌	朱	明昌	伯際
趙傚	趙	傚	肖甫
陸夢龍	陸	夢龍	君啟
陳萬善	陳	萬善	可一
何顯宗	何	顯宗	昆謀
鍾惺	鍾	惺	伯敬
徐爾恒	徐	爾恒	象一
石應嵩	石	應嵩	兆甫
顏容暄	顏	容暄	孚儒
鍾世芳	鍾	世芳	惟馨
張鯉	張	鯉	
喬承詔	喬	承詔	揚明
苗進忠	苗	進忠	藎臣
江桂	江	桂	元直
王安舜	王	安舜	性父
鄭之范	鄭	之范	憲正
施鵬	施	鵬	祖鯤
白受采	白	受采	素臣
宋綂殷	宋	綂殷	獻徵
甄淑	甄	淑	爾儀
陳應春	陳	應春	載陽
鄭元昭	鄭	元昭	二資
鄭振光	鄭	振光	明初
馮汝京	馮	汝京	宋繹
王志堅	王	志堅	淑士
盧瑛田	盧	瑛田	虹仲；龍升
李茂英	李	茂英	君秀
陳伯英	陳	伯英	駿干
郭忠宁	郭	忠宁	藎卿
李達	李	達	道行
陳應元	陳	應元	長孺
錢謙益	錢	謙益	受之
張國紳	張	國紳	書卿
魏運開	魏	運開	啟元
李春皜	李	春皜	元素
李楨寧	李	楨寧	汝立
楊之璋	楊	之璋	錫之
劉進明	劉	進明	譽卿
劉重慶	劉	重慶	耳枝
周士昌	周	士昌	小翼
李遇知	李	遇知	仲之
周家椿	周	家椿	世□
翁家春	翁	家春	啟陽
譚性教	譚	性教	生伯
張士雅	張	士雅	德純
顧起鳳	顧	起鳳	羽王
劉康祉	劉	康祉	以吉
王元爽	王	元爽	洪亮
顧師曾	顧	師曾	唯甫
楊巨鯨	楊	巨鯨	文瀾
趙琦	趙	琦	伯玉
王象春	王	象春	季木
明時舉	明	時舉	直卿
李燁然	李	燁然	文若
李希孔	李	希孔	子鑄
張鳳圖	張	鳳圖	瑞唐
張翼明	張	翼明	伯寅
馬鳴起	馬	鳴起	伯龍
葉官	葉	官	謙卿
孫枝芳	孫	枝芳	恩紹
冼憲祖	冼	憲祖	懋章
董繼周	董	繼周	茂文
何朝宗	何	朝宗	學寔
徐之蛟	徐	之蛟	霖卿
宋一麟	宋	一麟	仲符
施逢元	施	逢元	惟貞
何應瑞	何	應瑞	聖符
李一公	李	一公	闇生
張光前	張	光前	爾荷
李自榮	李	自榮	元伯
薛大中	薛	大中	允執
陳翼飛	陳	翼飛	元朋
党中疇	党	中疇	易甫
徐遵宗	徐	遵宗	務滋
陳睿謨	陳	睿謨	常采
唐暉	唐	暉	文季
游士任	游	士任	伊仲；肩生
楊呈秀	楊	呈秀	子實
洪雲蒸	洪	雲蒸	化卿
王良臣	王	良臣	忠亮
袁鳴泰	袁	鳴泰	六階
田吉	田	吉	兆元
汪元哲	汪	元哲	魯生
韓敬	韓	敬	求仲
馮一經	馮	一經	羽明
程註	程	註	爾雅
朱期昌	朱	期昌	辰翁
張庭	張	庭	居敬
蔣英	蔣	英	𣶬甫
龔之伊	龔	之伊	圓甫；查先
丘履嘉	丘	履嘉	原禮
陳之淯	陳	之淯	澹夫
黃聖期	黃	聖期	逢一
黃一鳳	黃	一鳳	時鳴
常道立	常	道立	修之
王弘祖	王	弘祖	繩廓
許大成	許	大成	齋文
宋學道	宋	學道	仲明
潘融春	潘	融春	季豫
周爾發	周	爾發	子祥
李聞詩	李	聞詩	興予
史贊舜	史	贊舜	元亮
魏光國	魏	光國	士為
文三俊	文	三俊	文瀛
王瀠	王	瀠	帶如
傅相殷	傅	相殷	惟肖
李中行	李	中行	與之
楊一鵬	楊	一鵬	大友
王念祖	王	念祖	孝先
史孔吉	史	孔吉	敬勝
張國柱	張	國柱	維楨
魏士前	魏	士前	定如
王時和	王	時和	元調
孫織錦	孫	織錦	伯闇
史高先	史	高先	紹卿
朱綵	朱	綵	澹父
胡一鴻	胡	一鴻	季漸
施槃	施	槃	宗銘
楊鼎	楊	鼎	宗器
倪謙	倪	謙	克讓
張和	張	和	節之
錢溥	錢	溥	原溥
章綸	章	綸	大經
劉孚	劉	孚	誠之
祝顥	祝	顥	維清
夏遂	夏	遂	存良
李鳳	李	鳳	朝陽
陳升	陳	升	謹順
張勛	張	勛	彜鼎
黃琛	黃	琛	廷獻
張瓛	張	瓛	惟敬
劉彧	劉	彧	著章
孟玘	孟	玘	廷振
張穆	張	穆	敬之
周賢	周	賢	用希
周天民	周	天民	希尹
王彰	王	彰	廷顯
甘敬脩	甘	敬脩	示勉
林聰	林	聰	季聰
張瑭	張	瑭	廷玉
殷謙	殷	謙	文撝
楊璿	楊	璿	叔璣
俞鐸	俞	鐸	振文
羅瑛	羅	瑛	慶清
王儉	王	儉	用節
王宇	王	宇	仲宏
張勉	張	勉	克勤
章繪	章	繪	尚素
歐文整	歐	文整	正宗
王竑	王	竑	公度
尚達	尚	達	兼善
豐慶	豐	慶	□
孟瑛	孟	瑛	彥輝
姚堂	姚	堂	彥容
劉煒	劉	煒	有融
莫震	莫	震	霆威
鄒幹	鄒	幹	宗盛
胡拱辰	胡	拱辰	共之
毛鳳	毛	鳳	彩鳳
呂囦	呂	囦	希顏
李榮	李	榮	志仁
劉澣	劉	澣	自新
劉晟	劉	晟	景隆
馬經	馬	經	用常
張鉞	張	鉞	大器
汪滸	汪	滸	清夫
陳价	陳	价	維藩
周濠	周	濠	文淵
劉玭 	劉	玭 	求素
李泰	李	泰	興道
劉芳	劉	芳	永馨
楊瑛	楊	瑛	德華
何子聰	何	子聰	友聞
聶智	聶	智	志節
焦寛	焦	寛	仲容
單宇	單	宇	時泰
李郁	李	郁	若虛
秦中	秦	中	時中
陳瓚	陳	瓚	重器
李璨	李	璨	子珍
方澥	方	澥	源深
張斌	張	斌	文質
劉善慶	劉	善慶	祐之
王銳	王	銳	允威
焦從周	焦	從周	孟文
蕭翼	蕭	翼	體全
傅文	傅	文	公器
張諫	張	諫	孟弼
王晏	王	晏	仲清
李茂	李	茂	岳楙
虞廷璽	虞	廷璽	瑄（名）
李時	李	時	習之
謝琛	謝	琛	伯玉
王訥	王	訥	敏行
劉深	劉	深	資之
王澤	王	澤	濟民
楊貢	楊	貢	彥魁
毛祥	毛	祥	原吉
李柰	李	柰	景春
王彧	王	彧	秉文
李遜	李	遜	時敏
劉同	劉	同	伯詢
鄭崇	鄭	崇	尚德
成始終	成	始終	敬之
李善	李	善	元吉
劉益	劉	益	謙之
劉訓	劉	訓	忠言
劉觀	劉	觀	崇觀
郭仲南	郭	仲南	仲南
尚褫	尚	褫	景福
喬瑛	喬	瑛	文玉
陳鈍	陳	鈍	魯若
牛吉	牛	吉	伯□
王信	王	信	以誠
賈恪	賈	恪	惟恭
王璟	王	璟	仲瑩
劉儼	劉	儼	宣化
呂原	呂	原	逢原
黃諫	黃	諫	廷臣
陳宜	陳	宜	公宜
徐簡	徐	簡	易道
龍澄	龍	澄	太淵
沈琮	沈	琮	公禮
鄒允隆	鄒	允隆	允隆
姚夔	姚	夔	大章
甯瑛	甯	瑛	廷玉
朱榮	朱	榮	廷寵
劉曦	劉	曦	玉暉
王復	王	復	初陽
張瀾	張	瀾	道本
解延年	解	延年	世紀
李森	李	森	叔嚴
宋儒	宋	儒	宗魯
黃裳	黃	裳	元吉
潘英	潘	英	時彥
潘鑑	潘	鑑	庶瞻
余瓚	余	瓚	世用
左鼎	左	鼎	周器
包良佐	包	良佐	克忠
孫振望	孫	振望	儼（名）
南昱	南	昱	時芳
沈彬	沈	彬	原質
洪繩	洪	繩	文綱
姚龍	姚	龍	納言
鄭序	鄭	序	志禮
劉鍇	劉	鍇	用甫
翟敬	翟	敬	致恭
王概	王	概	同節
顧孟喬	顧	孟喬	仁春
王英	王	英	孟育
胡珉	胡	珉	文珮
劉子鍾	劉	子鍾	廷振
胡淵	胡	淵	仲深
鄭清	鄭	清	廷憲
項忠	項	忠	藎臣
蕭儼	蕭	儼	畏之
葉春	葉	春	時元
盧祥	盧	祥	仲和
李正芳	李	正芳	彥碩
張雲翰	張	雲翰	鷹揚
劉福	劉	福	崇善
俞鑑	俞	鑑	元器
魯文	魯	文	文明
李鑑	李	鑑	明遠
熊璘	熊	璘	文玉
王儼	王	儼	民望
劉華甫	劉	華甫	華甫
干璠	干	璠	廷玉
韓雍	韓	雍	永熙
鄧貴	鄧	貴	安達
秦顒	秦	顒	士昂
羅如墉	羅	如墉	本崇
周鐸	周	鐸	秉訓
楊鏞	楊	鏞	克宣
鄧顒	鄧	顒	伯昂
甘澤	甘	澤	洪濟
羅澄	羅	澄	景深
吳節	吳	節	天敘
童守宏	童	守宏	守宏
陳璣	陳	璣	文奎
鄭溫	鄭	溫	厲夫
王詔	王	詔	伯宣
田玹	田	玹	廷玉
張瑄	張	瑄	廷璽
楊益	楊	益	光謙
楊政	楊	政	以仁
江淵	江	淵	如淵
朱驥	朱	驥	漢房
聞人韺	聞	人韺	以和
呂昌	呂	昌	好隆
張純	張	純	存純
黃鍾	黃	鍾	功鼎
高安	高	安	容靜
謝紳	謝	紳	偉儀
徐正	徐	正	惟中
李實	李	實	孟誠
黃仕儁	黃	仕儁	廷臣
王理	王	理	淑庸
馬顯	馬	顯	文明
張瑛	張	瑛	廷玉
馬頊	馬	頊	士欽
唐鍾	唐	鍾	廷用
徐善	徐	善	文善
路璧	路	璧	斐資
尹鈜	尹	鈜	泰和
王庾	王	庾	仲京
陳浩	陳	浩	仲知
尹禮	尹	禮	內則
郎勝	郎	勝	汝彬
章文	章	文	彥英
謝睿	謝	睿	邦達
畢鸞	畢	鸞	沖霄
翁世資	翁	世資	世資
夏裕	夏	裕	孔裕
鄭敬	鄭	敬	德聚
閻寬	閻	寬	德厚
胡貫	胡	貫	一貫
曾昂	曾	昂	仲英
左輔	左	輔	良弼
黃宗	黃	宗	廷禮
芮釗	芮	釗	宗遠
辛浩	辛	浩	養正
劉懷	劉	懷	以德
董昱	董	昱	文昭
駱敏	駱	敏	士聰
歐陽正	歐陽	正	楷正
強宏	強	宏	仕容
婁良	婁	良	至善
王凱	王	凱	舜舉
楊觀	楊	觀	尚賓
曹祥	曹	祥	致和
鄭寧	鄭	寧	志道
魏貞	魏	貞	正己
黃禎	黃	禎	膺祉
劉賢	劉	賢	時舉
任寧	任	寧	靖之
黃鑑	黃	鑑	克明
楊愈	楊	愈	希賢
丘嵩	丘	嵩	崇高
李侃	李	侃	希正
沈訥	沈	訥	敏行
錢森	錢	森	廷茂
鍾成	鍾	成	子完
張文質	張	文質	允中
酆海	酆	海	朝宗
汪琰	汪	琰	廷用
王宣	王	宣	明理
高謙	高	謙	□□
郝璜	郝	璜	廷器
熊文	熊	文	彥奎
陳汝言	陳	汝言	訥之
白圭	白	圭	宗玉
劉玘	劉	玘	仲玉
陳銓	陳	銓	文衡
倪讓	倪	讓	允恭
劉讓	劉	讓	撝謙
薛遠	薛	遠	繼遠
李瑤	李	瑤	仲玉
張惠	張	惠	澤民
程信	程	信	彥實
常茂	常	茂	景榮
甘節	甘	節	尚忠
薛幹	薛	幹	景廉
萬祥	萬	祥	載道
邵進	邵	進	文升
商輅	商	輅	弘載
周洪謨	周	洪謨	堯佐
劉俊	劉	俊	世英
曾蒙簡	曾	蒙簡	蒙簡
夏時正	夏	時正	尚行
蕭彝	蕭	彝	元衷
章綸	章	綸	絲綸
崔璵	崔	璵	宗器
陳律	陳	律	正律
錢慱	錢	慱	原慱
全智	全	智	克明
張洪	張	洪	淵濬
陳濂	陳	濂	德清
葉武	葉	武	繼武
馮維	馮	維	文綱
方杲	方	杲	景輝
許振	許	振	玉亮
黃霖	黃	霖	濟民
葉冕	葉	冕	拱宸
宋瑮	宋	瑮	克純
杜銘	杜	銘	敬脩
陳璉	陳	璉	器之
李梁	李	梁	廷進
李庸脩	李	庸脩	庸脩
劉孜	劉	孜	顯孜
林義	林	義	尚質
李賓	李	賓	廷用
李叔玉	李	叔玉	叔玉
張春	張	春	時中
朱海	朱	海	克寬
王鎮	王	鎮	景安
葉盛	葉	盛	與中
盛俊	盛	俊	用章
劉珷	劉	珷	次珣
項璁	項	璁	彥輝
浦清	浦	清	宗源
錢昕	錢	昕	景寅
金亮	金	亮	克明
周宣	周	宣	政舉
周旋	周	旋	中禮
羅紳	羅	紳	朝用
劉會	劉	會	嘉會
陸厚	陸	厚	文載
徐昌	徐	昌	德茂
徐瑄	徐	瑄	子敬
卞榮	卞	榮	華伯
應顥	應	顥	文明
劉昌	劉	昌	欽謨
陳雲鵬	陳	雲鵬	翼之
陳暄	陳	暄	體日
許仕達	許	仕達	廷佐
王福	王	福	宗善
金愷	金	愷	元之
陶銓　	陶	銓　	文衡
許箎	許	箎	仲樂
沈綱	沈	綱	孟舉
劉諭	劉	諭	偕立
姚恭	姚	恭	彥遜
林時深	林	時深	時深
趙訪	趙	訪	資善
吳中	吳	中	行準
周鑑	周	鑑	孔明
羅箎	羅	箎	應韶
沈和	沈	和	用禮
胡濬	胡	濬	源大淵
徐彬	徐	彬	寅白
盛琦	盛	琦	廷璧
袁廣	袁	廣	仲弘
楊渙	楊	渙	德濟
林長清	林	長清	長清
王鉉	王	鉉	宗鼐
丁璿	丁	璿	大器
李友聞	李	友聞	進明
王允	王	允	執中
楊禮和	楊	禮和	節之
陳善	陳	善	復初
徐行	徐	行	順理
趙昂	趙	昂	伯顒
童存德	童	存德	居敬
毛珍	毛	珍	廷貴
張紳	張	紳	仲書
衛儀	衛	儀	彥威
尹恕	尹	恕	惠行
涂謙	涂	謙	恒讓
胡深	胡	深	文淵
周瑩	周	瑩	吹玉
唐維	唐	維	叔方
陳璚	陳	璚	公美
樓澤	樓	澤	仁甫
呂正	呂	正	孟端
趙永寧	趙	永寧	世安
李奎	李	奎	文輝
馮時	馮	時	世隆
陳方	陳	方	正觀
孫祥	孫	祥	廷瑞
曹凱	曹	凱	宗原
陳寬	陳	寬	用弘
甯良	甯	良	元善
李錫	李	錫	祐之
申祐	申	祐	䒶錫
季駿	季	駿	文華
陳詠	陳	詠	永言
王紹	王	紹	繼先
王宣	王	宣	德昭
林廷舉	林	廷舉	雲鵬
周璹	周	璹	式廉
原傑	原	傑	子英
宋璽	宋	璽	廷玉
宋欽	宋	欽	克敬
史敏	史	敏	德敏
張讓	張	讓	孟謙
高閏	高	閏	居正
田瑧	田	瑧	志道
馬垸	馬	垸	伯圃
朱縉	朱	縉	廷儀
莊敏	莊	敏	廷功
王敞	王	敞	文浩
陳叔紹	陳	叔紹	叔紹
向敬	向	敬	行簡
柴文顯	柴	文顯	道明
蘇霔	蘇	霔	克滋
董方	董	方	中矩
嚴樞	嚴	樞	務正
曹得	曹	得	希賢
劉羽翔	劉	羽翔	雲程
黃鎬	黃	鎬	□高
何琛	何	琛	廷玉
劉璉	劉	璉	宗器
盧中	盧	中	守正
邊永	邊	永	仕遠
馬馴	馬	馴	德良
周瑜	周	瑜	廷璧
陳瓛	陳	瓛	䒶錫
朱英	朱	英	時傑
胡瑞	胡	瑞	方正
張翰	張	翰	宗儒
齊讓	齊	讓	守禮
黃綬	黃	綬	文璽
王瓖	王	瓖	宗璽
高安	高	安	子寧
沈紀	沈	紀	文振
潘伯通	潘	伯通	學古
戴珤	戴	珤	廷用
李和	李	和	時中
姚哲	姚	哲	文明
曾卓	曾	卓	瀹沂
鄭瑄	鄭	瑄	廷璽
潘暄	潘	暄	時陽
丁本	丁	本	弘道
蕭斌	蕭	斌	得宜
彭時	彭	時	純道
陳鑑	陳	鑑	緝熙
岳正	岳	正	季方
萬安	萬	安	循吉
曹日鼎	曹	日鼎	萬鎰
毛玉	毛	玉	良器
陳錡	陳	錡	鼎夫
羅俊	羅	俊	承彥
夏寅	夏	寅	時正
梅倫	梅	倫	彥常
徐溥	徐	溥	仕弘
黃溥	黃	溥	澄濟
翁世用	翁	世用	世用
胡皞	胡	皞	樂熙
錢澍	錢	澍	民望
劉景星	劉	景星	景升
周瑚	周	瑚	公器
邢宥	邢	宥	克寬
熊瓚	熊	瓚	宗器
王常	王	常	大經
王汝霖	王	汝霖	民望
康圭	康	圭	爾錫
朱序	朱	序	宜載
楊宜	楊	宜	彥理
桂怡	桂	怡	廷顏
劉洙	劉	洙	東周
劉吉	劉	吉	祐之
何陞	何	陞	文達
何宜	何	宜	行義
倪敬	倪	敬	汝敬
周琰	周	琰	廷粲
孫茂	孫	茂	庭蘭
張聰	張	聰	士敏
沈義	沈	義	時宜
鄭顯	鄭	顯	廷謨
劉珝	劉	珝	叔溫
吳禮	吳	禮	貴和
李蕃	李	蕃	廷茂
沈琮	沈	琮	廷器
汪回顯	汪	回顯	汝光
王勤	王	勤	而勉
謝昶	謝	昶	伯明
謝瓌	謝	瓌	良珍
黃譽	黃	譽	廷永
譚廣	譚	廣	克寬
白行順	白	行順	致和
李英	李	英	尚賢
宋弼	宋	弼	良輔
沈敬	沈	敬	克欽
高崇	高	崇	惟志
蔣敷	蔣	敷	宗德
徐珢	徐	珢	廷玉
戴珉	戴	珉	廷振
李玘	李	玘	廷紳
朱永寧	朱	永寧	永寧
曾瓚	曾	瓚	廷器
邢讓	邢	讓	遜之
劉清	劉	清	廉夫
謝騫	謝	騫	鵬舉
車寧	車	寧	子靜
陳俊	陳	俊	□英
焦鈍	焦	鈍	秉聰
王琮	王	琮	良璧
李本道	李	本道	正倫
蕭九成	蕭	九成	鳳儀
秦敬	秦	敬	克恭
沈瓛	沈	瓛	廷玉
喬毅	喬	毅	志弘
李本	李	本	立之
方輔	方	輔	廷臣
黃節	黃	節	順中
余複	余	複	存美
汪甫	汪	甫	景新
李鏞	李	鏞	廷器
王恕	王	恕	宗貫
舒庭謨	舒	庭謨	宗弼
孫昱	孫	昱	廷昭
吳淳	吳	淳	厚伯
王芳	王	芳	宇直
孟祥	孟	祥	廷瑞
李尚	李	尚	尚文
彭廣	彭	廣	深慱
尹旻	尹	旻	同仁
張斐	張	斐	文著
王讓	王	讓	克讓
戴昂	戴	昂	時舉
劉泰	劉	泰	皆亨
黃裳	黃	裳	懋臣
洪常	洪	常	子經
葉祿	葉	祿	祿元
李讚	李	讚	公美
閉悌	閉	悌	孔仁
李寬	李	寬	宗裕
張鎣	張	鎣	廷器
王正	王	正	嗣宗
王璧	王	璧	廷玉
鄭文康	鄭	文康	時乂
江真	江	真	士元
華顯	華	顯	用明
盛綸	盛	綸	以端
唐澞	唐	澞	源潔
王育	王	育	養民
沈祥	沈	祥	應禎
張奎	張	奎	文明
謝琚	謝	琚	仲玉
周騤	周	騤	世良
潘榮	潘	榮	尊用
王璽	王	璽	廷用
霍榮	霍	榮	文華
周翔	周	翔	鵬舉
劉濟	劉	濟	時用
王玭	王	玭	弘章
黃紱	黃	紱	用章
任孜	任	孜	懋善
郭安	郭	安	邦寧
呂鐸	呂	鐸	文振
李堅	李	堅	景義
越堅	越	堅	志剛
高瑛	高	瑛	廷璧
張純	張	純	惟一
朱瑄	朱	瑄	廷徵
李璉	李	璉	重器
孫瓊	孫	瓊	蘊章
王豪	王	豪	人傑
瞿泰安	瞿	泰安	伯陽
廖俊	廖	俊	崇傑
葉普亮	葉	普亮	廣熙
楊進	楊	進	曰俊
成章	成	章	文達
盧昇	盧	昇	孔昭
楊瓚	楊	瓚	廷器
陳璘	陳	璘	文玉
黃得溫	黃	得溫	伯理
楊恕	楊	恕	勉仁
